laua,laua_name,All Premises,All Matched Premises,SFBB availability (% premises),UFBB (100Mbit/s) availability (% premises),UFBB availability (% premises),Full Fibre availability (% premises),Gigabit availability (% premises),% of premises unable to receive 2Mbit/s,% of premises unable to receive 5Mbit/s,% of premises unable to receive 10Mbit/s,% of premises unable to receive 30Mbit/s,% of premises below the USO,% of premises with NGA,% of premises able to receive decent broadband from FWA,Number of premises with SFBB availability,Number of premises with UFBB (100Mbit/s) availability,Number of premises with UFBB availability,Number of premises with Full Fibre availability,Number of premises with Gigabit availability,Number of premises unable to receive 2Mbit/s,Number of premises unable to receive 5Mbit/s,Number of premises unable to receive 10Mbit/s,Number of premises unable to receive 30Mbit/s,Number of premises below the USO,Number of premises with NGA,Number of premises able to receive decent broadband from FWA,Number of premises with 30<300Mbit/s download speed,Number of premises with >=300Mbit/s download speed,Number of premises with 0<2Mbit/s download speed,Number of premises with 2<5Mbit/s download speed,Number of premises with 5<10Mbit/s download speed,Number of premises with 10<30Mbit/s download speed,% of premises with 30<300Mbit/s download speed,% of premises with >=300Mbit/s download speed,% of premises with 0<2Mbit/s download speed,% of premises with 2<5Mbit/s download speed,% of premises with 5<10Mbit/s download speed,% of premises with 10<30Mbit/s download speed
S12000033,ABERDEEN CITY,127083,126107,94.4,61.5,55.8,51.2,51.2,0.1,0.2,0.6,4.8,0.1,96.3,0.0,119995,78207,70870,65027,65027,65,210,719,6112,102,122381,0,49125,70870,65,145,509,5393,38.7,55.8,0.1,0.1,0.4,4.2
S12000034,ABERDEENSHIRE,126320,125293,83.2,11.7,11.6,11.6,11.6,2.6,5.7,9.2,16.0,4.0,94.5,0.0,105047,14784,14694,14592,14592,3241,7207,11602,20246,5089,119317,0,90353,14694,3241,3966,4395,8644,71.5,11.6,2.6,3.1,3.5,6.8
E07000223,ADUR,29865,29795,98.7,85.7,85.4,1.5,1.5,0.0,0.0,0.2,1.1,0.0,99.4,0.0,29475,25597,25517,445,445,3,14,46,320,6,29673,0,3958,25517,3,11,32,274,13.3,85.4,0.0,0.0,0.1,0.9
E07000026,ALLERDALE,51812,51555,92.6,3.2,3.2,3.2,3.2,1.2,2.1,3.1,6.9,1.1,98.4,0.0,47999,1658,1658,1658,1658,601,1103,1616,3556,548,51008,0,46341,1658,601,502,513,1940,89.4,3.2,1.2,1.0,1.0,3.7
E07000032,AMBER VALLEY,61441,61100,95.2,30.8,27.4,24.3,24.3,0.1,0.3,0.7,4.2,0.3,98.5,0.0,58496,18928,16806,14910,14910,61,195,453,2604,154,60512,1,41690,16806,61,134,258,2151,67.9,27.4,0.1,0.2,0.4,3.5
S12000041,ANGUS,61118,60453,87.0,19.9,19.7,7.6,7.6,1.4,3.7,6.8,11.9,2.5,95.0,0.0,53187,12147,12046,4642,4642,878,2265,4160,7266,1498,58060,0,41141,12046,878,1387,1895,3106,67.3,19.7,1.4,2.3,3.1,5.1
N09000001,ANTRIM AND NEWTOWNABBEY,60863,60133,92.3,80.5,80.2,69.9,80.4,1.5,2.7,3.4,6.5,1.6,98.6,0.0,56176,48996,48811,42552,48939,943,1658,2056,3957,985,59999,0,7365,48811,943,715,398,1901,12.1,80.2,1.5,1.2,0.7,3.1
N09000011,ARDS AND NORTH DOWN,72711,72479,95.1,79.4,79.0,77.8,79.4,0.6,1.1,1.9,4.5,0.8,99.5,0.0,69175,57761,57477,56565,57757,430,805,1411,3304,557,72327,0,11698,57477,430,375,606,1893,16.1,79.0,0.6,0.5,0.8,2.6
S12000035,ARGYLL AND BUTE,56474,54792,78.2,1.6,1.6,1.6,1.6,3.2,6.0,10.4,18.8,7.8,88.0,0.0,44177,906,906,905,906,1780,3389,5883,10615,4396,49708,0,43271,906,1780,1609,2494,4732,76.6,1.6,3.2,2.8,4.4,8.4
N09000002,"ARMAGH CITY, BANBRIDGE AND CRAIGAVON",86086,85591,89.0,66.5,65.9,66.5,66.5,1.5,3.0,4.6,10.4,2.1,98.3,0.2,76611,57276,56766,57275,57275,1251,2575,3955,8980,1776,84587,136,19845,56766,1251,1324,1380,5025,23.1,65.9,1.5,1.5,1.6,5.8
E07000224,ARUN,79256,78955,96.5,14.5,10.6,8.3,8.3,0.1,0.2,0.3,3.1,0.1,99.3,0.0,76507,11513,8430,6560,6560,70,125,269,2448,73,78736,0,68077,8430,70,55,144,2179,85.9,10.6,0.1,0.1,0.2,2.7
E07000170,ASHFIELD,59345,59148,98.0,87.1,86.6,3.9,3.9,0.0,0.4,0.5,1.6,0.2,98.8,0.0,58172,51714,51396,2309,2309,9,223,297,976,100,58648,0,6776,51396,9,214,74,679,11.4,86.6,0.0,0.4,0.1,1.1
E07000105,ASHFORD,59032,58664,90.8,49.5,46.5,9.4,9.4,0.3,1.7,3.3,8.6,0.8,97.9,34.8,53614,29225,27424,5547,5547,170,994,1927,5050,472,57781,20517,26190,27424,170,824,933,3123,44.4,46.5,0.3,1.4,1.6,5.3
E07000200,BABERGH,43426,43075,93.9,15.0,14.6,10.6,10.6,0.4,0.8,1.1,5.3,0.4,98.5,8.0,40780,6502,6360,4603,4603,159,343,496,2295,191,42766,3487,34420,6360,159,184,153,1799,79.3,14.6,0.4,0.4,0.4,4.1
E09000002,BARKING AND DAGENHAM,80542,80463,98.3,90.0,89.8,51.3,89.8,0.0,0.5,0.9,1.6,0.0,98.3,0.0,79179,72477,72347,41332,72353,25,384,722,1284,40,79198,0,6832,72347,25,359,338,562,8.5,89.8,0.0,0.4,0.4,0.7
E09000003,BARNET,159780,159118,97.2,61.1,56.7,22.5,54.6,0.0,0.0,0.1,2.4,0.0,98.0,0.0,155271,97617,90598,36029,87281,1,25,172,3847,3,156613,0,64673,90598,1,24,147,3675,40.5,56.7,0.0,0.0,0.1,2.3
E08000016,BARNSLEY,117897,117509,97.9,69.9,66.6,22.9,22.9,0.1,0.2,0.4,1.8,0.0,99.0,0.0,115434,82400,78477,27019,27021,94,294,444,2075,29,116694,0,36957,78477,94,200,150,1631,31.3,66.6,0.1,0.2,0.1,1.4
E07000027,BARROW-IN-FURNESS,35576,35462,98.5,1.0,1.0,1.0,1.0,0.2,0.2,0.4,1.2,0.2,99.6,0.3,35036,357,357,357,357,54,80,131,426,54,35450,101,34679,357,54,26,51,295,97.5,1.0,0.2,0.1,0.1,0.8
E07000066,BASILDON,83724,83454,97.5,79.9,78.0,28.1,28.1,0.0,0.3,0.7,2.2,0.0,98.7,0.0,81601,66922,65324,23550,23550,24,217,569,1853,36,82598,0,16277,65324,24,193,352,1284,19.4,78.0,0.0,0.2,0.4,1.5
E07000084,BASINGSTOKE AND DEANE,82101,81784,95.4,57.3,55.3,25.4,55.1,0.2,0.6,1.2,4.2,0.5,97.9,0.0,78331,47005,45402,20836,45274,129,495,1003,3453,422,80365,0,32929,45402,129,366,508,2450,40.1,55.3,0.2,0.4,0.6,3.0
E07000171,BASSETLAW,57128,56686,95.5,34.7,32.8,9.3,9.3,0.4,0.8,1.2,3.7,0.4,98.6,6.7,54574,19813,18738,5324,5325,231,440,705,2112,244,56311,3828,35836,18738,231,209,265,1407,62.7,32.8,0.4,0.4,0.5,2.5
E06000022,BATH AND NORTH EAST SOMERSET,88774,88493,93.9,66.7,60.0,30.6,30.6,0.1,0.3,0.8,5.8,0.2,95.9,0.0,83346,59173,53298,27127,27127,122,231,672,5147,187,85097,1,30048,53298,122,109,441,4475,33.8,60.0,0.1,0.1,0.5,5.0
E06000055,BEDFORD,81782,81533,96.9,75.4,71.9,11.3,11.3,0.2,0.5,0.8,2.8,0.1,98.5,0.0,79231,61671,58763,9229,9229,144,372,685,2302,102,80585,1,20468,58763,144,228,313,1617,25.0,71.9,0.2,0.3,0.4,2.0
N09000003,BELFAST,167353,166054,97.9,92.1,91.8,76.1,91.8,0.0,0.1,0.3,1.3,0.3,98.1,0.0,163884,154057,153550,127409,153551,39,115,570,2170,533,164241,0,10334,153550,39,76,455,1600,6.2,91.8,0.0,0.0,0.3,1.0
E09000004,BEXLEY,103334,103094,97.4,81.0,79.8,42.9,79.2,0.0,0.1,0.7,2.4,0.1,97.9,0.0,100620,83750,82439,44297,81856,3,109,715,2474,56,101137,0,18181,82439,3,106,606,1759,17.6,79.8,0.0,0.1,0.6,1.7
E08000025,BIRMINGHAM,474775,471024,94.7,89.2,88.2,38.0,87.5,0.0,0.2,0.8,4.5,0.0,94.7,0.1,449459,423605,418565,180357,415375,35,784,3976,21565,53,449788,301,30894,418565,35,749,3192,17589,6.5,88.2,0.0,0.2,0.7,3.7
E07000129,BLABY,45414,45320,97.5,72.0,69.6,33.2,33.2,0.1,0.4,0.7,2.3,0.0,98.4,0.0,44258,32719,31605,15094,15094,34,183,323,1062,19,44673,0,12653,31605,34,149,140,739,27.9,69.6,0.1,0.3,0.3,1.6
E06000008,BLACKBURN WITH DARWEN,67530,67207,97.3,68.2,67.7,10.5,10.5,0.0,0.2,0.5,2.2,0.1,98.6,70.6,65714,46049,45749,7086,7104,27,157,315,1493,39,66618,47646,19965,45749,27,130,158,1178,29.6,67.7,0.0,0.2,0.2,1.7
E06000009,BLACKPOOL,77761,77500,98.4,70.8,70.6,0.8,0.8,0.0,0.0,0.0,1.3,0.0,98.5,8.8,76501,55065,54924,588,588,1,10,33,999,2,76632,6837,21577,54924,1,9,23,966,27.7,70.6,0.0,0.0,0.0,1.2
W06000019,BLAENAU GWENT,35278,35161,96.5,5.3,3.8,2.7,2.7,0.0,0.2,0.7,3.2,0.2,99.2,0.1,34026,1859,1345,937,937,14,88,237,1135,53,35001,18,32681,1345,14,74,149,898,92.6,3.8,0.0,0.2,0.4,2.5
E07000033,BOLSOVER,38967,38783,94.7,42.3,37.5,14.3,14.3,0.1,0.2,0.5,4.8,0.2,98.1,0.0,36913,16476,14605,5561,5561,41,97,206,1870,67,38227,0,22308,14605,41,56,109,1664,57.2,37.5,0.1,0.1,0.3,4.3
E08000001,BOLTON,133682,133130,98.2,87.6,85.8,10.5,84.5,0.0,0.1,0.3,1.4,0.0,98.9,1.9,131239,117114,114656,14039,112934,23,133,407,1891,66,132218,2602,16583,114656,23,110,274,1484,12.4,85.8,0.0,0.1,0.2,1.1
E07000136,BOSTON,33387,33051,91.3,4.8,4.8,4.8,4.8,0.6,1.4,2.2,7.7,1.1,97.1,2.9,30483,1602,1601,1602,1602,208,464,731,2568,378,32424,966,28882,1601,208,256,267,1837,86.5,4.8,0.6,0.8,0.8,5.5
E06000058,"BOURNEMOUTH, CHRISTCHURCH AND POOLE",198388,197005,97.9,81.9,79.4,28.6,28.6,0.2,0.2,0.3,1.4,0.1,98.8,0.2,194251,162447,157586,56828,56829,335,375,629,2754,129,196018,313,36665,157586,335,40,254,2125,18.5,79.4,0.2,0.0,0.1,1.1
E06000036,BRACKNELL FOREST,54431,54180,95.9,61.9,58.3,9.2,56.3,0.0,0.1,0.8,3.7,0.1,97.4,0.0,52190,33681,31755,5024,30618,22,73,455,1990,58,53008,0,20435,31755,22,51,382,1535,37.5,58.3,0.0,0.1,0.7,2.8
E08000032,BRADFORD,219302,218347,96.3,81.3,76.1,4.4,74.4,0.1,0.2,0.5,3.2,0.0,97.7,31.4,211225,178391,166817,9585,163145,155,491,1030,7122,54,214157,68933,44408,166817,155,336,539,6092,20.2,76.1,0.1,0.2,0.2,2.8
E07000067,BRAINTREE,70987,70636,95.0,20.4,20.4,20.4,20.4,0.3,0.7,1.3,4.5,0.3,97.6,11.4,67422,14483,14483,14449,14449,198,493,892,3214,215,69304,8098,52939,14483,198,295,399,2322,74.6,20.4,0.3,0.4,0.6,3.3
E07000143,BRECKLAND,66450,66162,91.1,24.8,23.1,21.8,21.8,0.7,1.7,2.9,8.4,1.7,97.6,0.0,60567,16486,15361,14492,14492,452,1134,1929,5595,1147,64874,5,45206,15361,452,682,795,3666,68.0,23.1,0.7,1.0,1.2,5.5
E09000005,BRENT,136241,134925,96.2,75.6,72.4,32.7,71.0,0.0,0.1,0.7,2.8,0.0,96.2,0.0,131095,103034,98591,44542,96704,6,182,943,3830,0,131111,0,32504,98591,6,176,761,2887,23.9,72.4,0.0,0.1,0.6,2.1
E07000068,BRENTWOOD,35612,35375,95.4,37.2,37.2,37.2,37.2,0.1,0.3,0.6,3.9,0.1,98.4,0.1,33990,13259,13258,13257,13257,29,109,225,1385,41,35027,41,20732,13258,29,80,116,1160,58.2,37.2,0.1,0.2,0.3,3.3
W06000013,BRIDGEND,67536,67297,97.3,46.0,37.5,32.7,32.7,0.0,0.1,0.6,2.3,0.0,98.9,36.5,65733,31043,25350,22074,22097,29,77,401,1564,24,66764,24631,40383,25350,29,48,324,1163,59.8,37.5,0.0,0.1,0.5,1.7
E06000043,BRIGHTON AND HOVE,141843,140681,97.1,84.5,80.9,9.9,9.9,0.0,0.1,0.7,2.1,0.0,97.3,0.0,137718,119851,114784,14085,14086,4,212,988,2963,4,138005,0,22934,114784,4,208,776,1975,16.2,80.9,0.0,0.1,0.5,1.4
E06000023,"BRISTOL, CITY OF",210877,209617,95.6,89.7,88.4,49.5,49.5,0.0,0.1,0.5,3.8,0.1,95.7,0.0,201574,189212,186402,104469,104482,13,168,1087,8043,120,201906,39,15172,186402,13,155,919,6956,7.2,88.4,0.0,0.1,0.4,3.3
E07000144,BROADLAND,61494,61226,94.2,44.0,40.4,8.0,8.0,0.3,0.8,1.6,5.3,1.2,98.5,0.0,57950,27029,24837,4926,4933,165,478,966,3276,734,60555,0,33113,24837,165,313,488,2310,53.8,40.4,0.3,0.5,0.8,3.8
E09000006,BROMLEY,146574,146360,97.5,86.0,85.7,16.4,77.7,0.0,0.2,0.4,2.4,0.0,98.5,0.0,142882,125993,125550,24003,113911,52,320,638,3478,70,144323,0,17332,125550,52,268,318,2840,11.8,85.7,0.0,0.2,0.2,1.9
E07000234,BROMSGROVE,45036,44830,97.0,71.7,71.6,51.6,71.6,0.1,0.3,0.6,2.6,0.1,99.2,0.1,43669,32291,32248,23224,32255,26,133,263,1161,67,44685,56,11421,32248,26,107,130,898,25.4,71.6,0.1,0.2,0.3,2.0
E07000095,BROXBOURNE,43065,43029,98.7,88.1,84.6,5.1,5.1,0.1,0.1,0.2,1.2,0.0,99.3,0.0,42502,37945,36425,2210,2210,24,36,97,527,4,42771,0,6077,36425,24,12,61,430,14.1,84.6,0.1,0.0,0.1,1.0
E07000172,BROXTOWE,52308,52166,98.7,90.8,89.7,5.6,5.6,0.0,0.1,0.2,1.0,0.0,99.4,0.0,51636,47486,46944,2939,2939,14,55,106,530,4,51969,0,4692,46944,14,41,51,424,9.0,89.7,0.0,0.1,0.1,0.8
E06000060,BUCKINGHAMSHIRE,240443,239188,94.6,51.3,45.7,15.5,22.4,0.1,0.7,1.5,4.9,0.3,98.0,0.3,227408,123236,109977,37280,53949,281,1729,3602,11780,726,235554,685,117431,109977,281,1448,1873,8178,48.8,45.7,0.1,0.6,0.8,3.4
E07000117,BURNLEY,45403,45211,97.9,79.0,79.0,1.7,78.9,0.1,0.1,0.3,1.6,0.0,99.2,62.3,44464,35854,35846,767,35845,30,48,122,747,17,45025,28266,8618,35846,30,18,74,625,19.0,79.0,0.1,0.0,0.2,1.4
E08000002,BURY,89742,88521,97.3,73.7,68.4,50.4,64.2,0.0,0.1,0.2,1.3,0.2,98.5,0.0,87316,66160,61342,45241,57587,11,78,144,1205,152,88417,0,25974,61342,11,67,66,1061,28.9,68.4,0.0,0.1,0.1,1.2
W06000018,CAERPHILLY,83380,83074,98.1,31.0,27.4,25.6,25.6,0.1,0.1,0.2,1.5,0.0,99.4,47.0,81795,25858,22824,21337,21346,42,105,204,1279,30,82901,39217,58971,22824,42,63,99,1075,70.7,27.4,0.1,0.1,0.1,1.3
E08000033,CALDERDALE,103809,103303,95.0,52.1,51.5,13.9,13.9,0.1,0.4,0.7,4.5,0.1,98.3,0.0,98582,54049,53506,14443,14444,118,370,718,4721,68,102051,29,45076,53506,118,252,348,4003,43.4,51.5,0.1,0.2,0.3,3.9
E07000008,CAMBRIDGE,60017,59858,98.2,90.1,85.6,28.6,28.6,0.0,0.0,0.2,1.5,0.0,98.3,0.4,58941,54104,51395,17188,17188,1,20,114,917,2,58976,269,7546,51395,1,19,94,803,12.6,85.6,0.0,0.0,0.2,1.3
E09000007,CAMDEN,121536,120445,96.6,90.3,88.6,47.4,88.7,0.0,0.0,0.0,2.5,0.0,96.6,0.0,117370,109694,107736,57581,107842,0,0,8,3075,0,117377,3,9634,107736,0,0,8,3067,7.9,88.6,0.0,0.0,0.0,2.5
E07000192,CANNOCK CHASE,47910,47681,97.7,27.2,27.2,5.9,27.0,0.0,0.1,0.2,1.8,0.1,99.2,0.0,46820,13055,13010,2836,12944,16,38,106,861,59,47535,0,33810,13010,16,22,68,755,70.6,27.2,0.0,0.0,0.1,1.6
E07000106,CANTERBURY,73708,73336,94.1,3.7,3.7,3.7,3.7,0.2,0.5,1.0,5.4,0.2,99.1,14.6,69354,2737,2737,2738,2738,153,396,742,3982,177,73041,10759,66617,2737,153,243,346,3240,90.4,3.7,0.2,0.3,0.5,4.4
W06000015,CARDIFF,166181,165407,97.5,86.1,83.5,46.7,81.9,0.0,0.2,0.5,2.0,0.0,98.0,62.3,162061,143011,138834,77564,136065,31,334,893,3346,17,162844,103581,23227,138834,31,303,559,2453,14.0,83.5,0.0,0.2,0.3,1.5
E07000028,CARLISLE,57429,57082,94.1,54.5,48.1,6.0,6.0,0.8,1.6,2.6,5.3,1.3,97.5,0.1,54065,31311,27637,3467,3467,442,904,1486,3017,772,56021,36,26428,27637,442,462,582,1531,46.0,48.1,0.8,0.8,1.0,2.7
W06000010,CARMARTHENSHIRE,93256,92265,86.6,24.2,24.2,24.2,24.2,1.9,4.1,6.5,12.3,2.5,93.2,1.5,80797,22577,22577,22573,22573,1741,3823,6042,11468,2377,86886,1358,58220,22577,1741,2082,2219,5426,62.4,24.2,1.9,2.2,2.4,5.8
E07000069,CASTLE POINT,41060,40703,98.3,44.0,44.0,2.7,2.7,0.0,0.1,0.2,0.9,0.0,98.7,0.0,40353,18085,18069,1091,1091,14,43,67,350,10,40513,0,22284,18069,14,29,24,283,54.3,44.0,0.0,0.1,0.1,0.7
N09000004,CAUSEWAY COAST AND GLENS,66081,64566,85.8,56.6,56.6,56.6,56.6,2.3,4.3,5.8,11.9,4.0,97.0,0.0,56699,37406,37389,37402,37404,1530,2868,3837,7867,2635,64131,0,19310,37389,1530,1338,969,4030,29.2,56.6,2.3,2.0,1.5,6.1
E06000056,CENTRAL BEDFORDSHIRE,126796,126538,97.1,72.2,69.5,18.4,18.4,0.1,0.4,0.9,2.7,0.2,99.0,0.3,123171,91563,88101,23352,23352,128,470,1113,3367,277,125484,418,35070,88101,128,342,643,2254,27.7,69.5,0.1,0.3,0.5,1.8
W06000008,CEREDIGION,37624,37308,81.4,21.4,21.4,21.4,21.4,2.8,6.6,10.9,17.7,5.0,89.2,2.5,30640,8052,8052,8052,8052,1070,2491,4097,6668,1867,33555,958,22588,8052,1070,1421,1606,2571,60.0,21.4,2.8,3.8,4.3,6.8
E07000130,CHARNWOOD,79680,79461,98.3,74.8,71.6,10.7,10.7,0.1,0.2,0.4,1.4,0.1,99.2,0.0,78361,59574,57088,8525,8525,92,178,330,1100,75,79068,0,21273,57088,92,86,152,770,26.7,71.6,0.1,0.1,0.2,1.0
E07000070,CHELMSFORD,82389,82122,95.3,62.9,59.7,39.4,39.4,0.1,0.4,0.8,4.4,0.2,98.1,0.9,78536,51850,49171,32501,32501,50,324,662,3586,137,80828,739,29365,49171,50,274,338,2924,35.6,59.7,0.1,0.3,0.4,3.5
E07000078,CHELTENHAM,60186,59948,98.4,75.2,67.6,2.5,2.5,0.0,0.2,0.4,1.2,0.1,98.7,0.0,59203,45279,40706,1519,1519,20,119,270,745,33,59410,0,18497,40706,20,99,151,475,30.7,67.6,0.0,0.2,0.3,0.8
E07000177,CHERWELL,71706,71239,96.3,47.5,37.9,11.4,11.4,0.2,0.5,1.0,3.0,0.2,98.3,0.5,69076,34031,27189,8144,8144,179,325,729,2163,145,70455,363,41887,27189,179,146,404,1434,58.4,37.9,0.2,0.2,0.6,2.0
E06000049,CHESHIRE EAST,190833,189996,94.0,49.0,42.4,14.1,22.0,0.3,0.8,1.5,5.6,0.3,98.3,3.7,179348,93521,80890,26863,41988,528,1482,2861,10648,656,187519,7008,98458,80890,528,954,1379,7787,51.6,42.4,0.3,0.5,0.7,4.1
E06000050,CHESHIRE WEST AND CHESTER,169984,169423,95.2,51.9,45.2,27.6,27.6,0.1,0.6,1.2,4.5,0.3,98.7,0.5,161835,88148,76771,46931,46931,248,1033,1998,7588,489,167754,786,85064,76771,248,785,965,5590,50.0,45.2,0.1,0.5,0.6,3.3
E07000034,CHESTERFIELD,53400,53249,97.4,54.6,53.9,23.4,23.4,0.0,0.0,0.2,2.3,0.0,99.0,0.0,52004,29176,28757,12520,12520,0,13,91,1245,9,52868,0,23247,28757,0,13,78,1154,43.5,53.9,0.0,0.0,0.1,2.2
E07000225,CHICHESTER,62479,61732,90.5,25.2,22.8,21.2,21.2,0.3,1.0,2.1,8.3,1.0,97.8,0.0,56573,15740,14276,13274,13274,206,603,1328,5159,640,61114,0,42297,14276,206,397,725,3831,67.7,22.8,0.3,0.6,1.2,6.1
E07000118,CHORLEY,54826,54573,96.0,64.2,61.0,18.4,18.4,0.1,0.2,0.7,3.6,0.1,98.9,31.6,52622,35191,33458,10079,10080,30,125,372,1951,56,54197,17345,19164,33458,30,95,247,1579,35.0,61.0,0.1,0.2,0.5,2.9
S12000036,CITY OF EDINBURGH,265949,265526,97.5,87.4,85.5,46.5,84.3,0.0,0.2,0.4,2.3,0.0,98.0,0.0,259433,232315,227451,123765,224289,110,423,1059,6093,35,260545,5,31982,227451,110,313,636,5034,12.0,85.5,0.0,0.1,0.2,1.9
E09000001,CITY OF LONDON,10871,10743,56.2,47.3,46.7,45.9,46.6,0.0,0.0,0.0,42.7,0.0,56.2,0.0,6105,5142,5072,4994,5069,0,0,0,4638,0,6105,1,1033,5072,0,0,0,4638,9.5,46.7,0.0,0.0,0.0,42.7
S12000005,CLACKMANNANSHIRE,25947,25784,95.2,30.2,19.5,15.1,15.1,0.1,0.2,0.4,4.2,0.2,99.2,0.0,24700,7843,5065,3923,3923,29,50,96,1084,63,25730,0,19635,5065,29,21,46,988,75.7,19.5,0.1,0.1,0.2,3.8
E07000071,COLCHESTER,88099,87278,94.7,57.3,56.9,11.5,11.5,0.1,0.9,1.6,4.4,0.2,96.6,7.6,83395,50448,50143,10126,10126,113,777,1439,3883,172,85077,6680,33252,50143,113,664,662,2444,37.7,56.9,0.1,0.8,0.8,2.8
W06000003,CONWY,59406,59269,94.4,9.2,9.2,9.2,9.2,0.7,1.7,2.9,5.4,1.2,97.6,58.4,56054,5492,5492,5492,5492,430,1030,1718,3215,712,57971,34699,50562,5492,430,600,688,1497,85.1,9.2,0.7,1.0,1.2,2.5
E07000029,COPELAND,35722,35570,95.0,1.7,1.7,1.7,1.7,0.3,0.7,1.4,4.6,1.1,98.9,0.0,33924,609,609,609,609,110,260,486,1646,405,35340,0,33315,609,110,150,226,1160,93.3,1.7,0.3,0.4,0.6,3.2
E06000052,CORNWALL,301199,298233,87.2,36.2,34.9,32.0,32.0,0.3,1.0,2.4,11.9,0.9,92.3,4.5,262510,108981,104999,96374,96374,931,3089,7103,35723,2594,278012,13504,157511,104999,931,2158,4014,28620,52.3,34.9,0.3,0.7,1.3,9.5
E07000079,COTSWOLD,47464,47167,93.1,38.8,38.4,38.2,38.2,0.1,0.6,1.4,6.3,0.8,94.9,0.6,44175,18437,18211,18149,18149,59,297,648,2992,361,45029,286,25964,18211,59,238,351,2344,54.7,38.4,0.1,0.5,0.7,4.9
E06000047,COUNTY DURHAM,260274,259144,94.1,27.7,23.6,19.7,19.7,0.4,0.8,1.5,5.4,0.4,98.4,0.9,244972,72116,61502,51403,51403,918,2193,3829,14172,1100,256175,2312,183470,61502,918,1275,1636,10343,70.5,23.6,0.4,0.5,0.6,4.0
E08000026,COVENTRY,148725,148184,98.0,93.0,92.8,86.5,92.8,0.0,0.4,0.6,1.6,0.0,98.1,0.1,145763,138254,137976,128664,138028,5,530,889,2421,11,145901,167,7787,137976,5,525,359,1532,5.2,92.8,0.0,0.4,0.2,1.0
E07000163,CRAVEN,30256,30026,92.1,23.2,17.8,12.7,12.7,1.0,1.8,2.9,7.1,0.7,97.1,44.5,27867,7015,5386,3840,3853,308,548,889,2159,219,29380,13457,22481,5386,308,240,341,1270,74.3,17.8,1.0,0.8,1.1,4.2
E07000226,CRAWLEY,49289,49199,98.7,85.0,84.4,3.4,3.4,0.0,0.1,0.3,1.1,0.1,99.2,0.0,48653,41914,41605,1689,1689,6,45,140,546,48,48876,0,7048,41605,6,39,95,406,14.3,84.4,0.0,0.1,0.2,0.8
E09000008,CROYDON,168582,168036,96.0,84.5,83.4,23.8,83.3,0.0,0.1,0.3,3.6,0.0,96.6,0.0,161906,142453,140620,40083,140501,1,86,510,6130,16,162847,0,21286,140620,1,85,424,5620,12.6,83.4,0.0,0.1,0.3,3.3
E07000096,DACORUM,68989,68750,96.6,76.6,74.3,11.1,11.1,0.1,0.4,0.7,3.0,0.1,98.7,0.0,66648,52853,51256,7638,7639,90,289,498,2102,91,68110,0,15392,51256,90,199,209,1604,22.3,74.3,0.1,0.3,0.3,2.3
E06000005,DARLINGTON,54684,54557,94.5,83.9,83.5,2.9,2.9,0.7,1.8,2.9,5.2,0.3,96.1,23.4,51688,45897,45644,1574,1589,376,1008,1602,2869,164,52534,12809,6044,45644,376,632,594,1267,11.1,83.5,0.7,1.2,1.1,2.3
E07000107,DARTFORD,49684,49631,97.0,74.4,72.6,38.7,71.1,0.3,0.6,0.9,2.9,0.0,98.6,0.0,48211,36979,36046,19217,35340,139,302,457,1420,16,49003,0,12165,36046,139,163,155,963,24.5,72.6,0.3,0.3,0.3,1.9
W06000004,DENBIGHSHIRE,49828,49428,89.9,11.3,11.3,11.3,11.3,0.8,1.9,4.0,9.3,1.3,94.4,30.7,44805,5644,5644,5644,5644,404,953,2008,4623,646,47018,15281,39161,5644,404,549,1055,2615,78.6,11.3,0.8,1.1,2.1,5.2
E06000015,DERBY,119470,118710,98.0,91.1,89.9,29.3,29.3,0.0,0.1,0.3,1.3,0.0,98.2,0.0,117126,108822,107422,34954,34993,12,110,368,1584,0,117345,0,9704,107422,12,98,258,1216,8.1,89.9,0.0,0.1,0.2,1.0
E07000035,DERBYSHIRE DALES,37512,37303,89.9,9.0,9.0,9.0,9.0,0.5,1.8,3.6,9.6,1.4,96.6,0.0,33719,3370,3370,3370,3370,206,673,1362,3584,541,36237,0,30349,3370,206,467,689,2222,80.9,9.0,0.5,1.2,1.8,5.9
N09000005,DERRY CITY AND STRABANE,62607,62320,91.0,77.0,76.9,63.9,77.0,2.2,3.4,4.6,8.6,2.9,98.6,0.0,56966,48199,48175,40033,48195,1382,2156,2870,5354,1818,61744,0,8791,48175,1382,774,714,2484,14.0,76.9,2.2,1.2,1.1,4.0
E08000017,DONCASTER,147076,146502,97.6,63.2,62.9,43.5,43.5,0.1,0.3,0.6,2.0,0.1,98.8,14.6,143559,92971,92481,64010,64010,105,423,839,2943,188,145320,21403,51078,92481,105,318,416,2104,34.7,62.9,0.1,0.2,0.3,1.4
E06000059,DORSET,190377,189191,93.1,13.8,13.2,10.7,10.7,0.2,0.7,1.3,6.3,0.4,98.1,2.8,177183,26243,25131,20317,20317,335,1244,2487,12008,804,186809,5249,152052,25131,335,909,1243,9521,79.9,13.2,0.2,0.5,0.7,5.0
E07000108,DOVER,55807,55553,93.2,38.0,38.0,11.8,11.8,0.5,0.9,1.7,6.3,0.3,98.3,32.7,52039,21217,21214,6584,6584,285,517,958,3514,154,54842,18222,30825,21214,285,232,441,2556,55.2,38.0,0.5,0.4,0.8,4.6
E08000027,DUDLEY,147632,147214,98.9,91.1,89.9,5.0,82.9,0.0,0.0,0.0,0.8,0.0,99.3,4.4,145989,134493,132651,7308,122412,1,12,72,1225,17,146603,6497,13338,132651,1,11,60,1153,9.0,89.9,0.0,0.0,0.0,0.8
S12000006,DUMFRIES AND GALLOWAY,82631,81095,84.8,6.3,6.3,6.3,6.3,1.7,3.9,6.7,13.3,3.8,95.2,0.0,70092,5213,5212,5212,5212,1415,3210,5565,11003,3119,78648,0,64880,5212,1415,1795,2355,5438,78.5,6.3,1.7,2.2,2.9,6.6
S12000042,DUNDEE CITY,79437,79383,98.6,88.6,86.3,9.8,9.8,0.0,0.0,0.2,1.3,0.0,99.2,0.0,78338,70367,68516,7784,7784,1,13,149,1045,2,78768,0,9822,68516,1,12,136,896,12.4,86.3,0.0,0.0,0.2,1.1
E09000009,EALING,149058,147983,97.0,73.5,71.2,13.2,71.0,0.0,0.1,0.9,2.2,0.0,97.1,0.0,144655,109556,106118,19609,105856,28,183,1327,3328,22,144673,1,38537,106118,28,155,1144,2001,25.9,71.2,0.0,0.1,0.8,1.3
S12000008,EAST AYRSHIRE,60564,60343,95.7,45.7,45.1,37.4,37.4,0.6,1.2,2.0,4.0,0.4,98.6,0.0,57939,27659,27297,22639,22639,373,705,1185,2404,253,59701,0,30642,27297,373,332,480,1219,50.6,45.1,0.6,0.5,0.8,2.0
E07000009,EAST CAMBRIDGESHIRE,40049,39626,95.2,46.7,40.4,26.1,26.1,0.4,0.9,1.5,3.8,0.3,98.4,30.7,38119,18719,16172,10459,10459,153,351,603,1507,116,39397,12311,21947,16172,153,198,252,904,54.8,40.4,0.4,0.5,0.6,2.3
E07000040,EAST DEVON,75060,74732,89.5,36.7,35.7,35.0,35.0,0.5,2.0,3.9,10.1,0.8,96.1,15.6,67182,27519,26788,26254,26254,403,1500,2933,7550,617,72143,11710,40394,26788,403,1097,1433,4617,53.8,35.7,0.5,1.5,1.9,6.2
S12000045,EAST DUNBARTONSHIRE,50456,50086,96.3,78.4,77.4,19.3,76.6,0.0,0.2,0.5,3.0,0.0,98.2,0.0,48568,39555,39042,9743,38670,21,105,266,1518,9,49541,0,9526,39042,21,84,161,1252,18.9,77.4,0.0,0.2,0.3,2.5
E07000085,EAST HAMPSHIRE,57716,57311,92.9,45.3,42.3,15.8,15.8,0.2,0.6,1.2,6.4,0.6,97.2,0.0,53646,26124,24414,9127,9127,94,329,716,3665,330,56100,0,29232,24414,94,235,387,2949,50.6,42.3,0.2,0.4,0.7,5.1
E07000242,EAST HERTFORDSHIRE,66839,66679,95.5,69.5,66.3,11.6,11.6,0.2,0.5,0.9,4.2,0.4,97.8,0.0,63857,46466,44319,7781,7781,124,321,597,2822,291,65383,0,19538,44319,124,197,276,2225,29.2,66.3,0.2,0.3,0.4,3.3
E07000137,EAST LINDSEY,72815,72252,87.9,19.4,15.7,4.3,4.3,1.0,2.6,4.8,11.3,2.3,97.0,11.1,64016,14108,11410,3099,3100,696,1920,3489,8236,1678,70626,8068,52606,11410,696,1224,1569,4747,72.2,15.7,1.0,1.7,2.2,6.5
S12000010,EAST LOTHIAN,49296,49090,92.9,32.1,31.9,32.0,32.1,0.4,1.4,2.4,6.7,0.4,97.4,36.1,45793,15802,15738,15798,15802,200,699,1172,3297,174,48027,17817,30055,15738,200,499,473,2125,61.0,31.9,0.4,1.0,1.0,4.3
S12000011,EAST RENFREWSHIRE,41174,41153,96.2,70.7,70.1,7.6,70.0,0.1,0.2,0.6,3.8,0.1,98.9,0.0,39600,29111,28862,3145,28832,38,101,236,1553,42,40706,0,10738,28862,38,63,135,1317,26.1,70.1,0.1,0.2,0.3,3.2
E06000011,EAST RIDING OF YORKSHIRE,166796,165494,95.8,64.7,63.6,62.8,62.8,0.4,0.9,1.4,3.4,0.2,98.4,31.9,159824,107930,106142,104827,104827,739,1551,2371,5670,401,164110,53272,53682,106142,739,812,820,3299,32.2,63.6,0.4,0.5,0.5,2.0
E07000193,EAST STAFFORDSHIRE,56051,55694,95.0,39.7,35.8,31.9,31.9,0.3,0.8,1.4,4.4,0.4,98.6,0.0,53233,22260,20040,17871,17871,162,445,796,2461,199,55274,0,33193,20040,162,283,351,1665,59.2,35.8,0.3,0.5,0.6,3.0
E07000244,EAST SUFFOLK,127242,126189,94.2,21.7,21.7,15.3,15.3,0.2,0.7,1.2,5.0,0.5,97.9,5.2,119875,27654,27599,19490,19490,208,841,1545,6314,676,124614,6654,92276,27599,208,633,704,4769,72.5,21.7,0.2,0.5,0.6,3.7
E07000061,EASTBOURNE,50920,50797,99.0,17.3,17.3,17.3,17.3,0.0,0.0,0.1,0.7,0.0,99.5,0.0,50427,8827,8827,8827,8827,0,12,54,370,3,50670,0,41600,8827,0,12,42,316,81.7,17.3,0.0,0.0,0.1,0.6
E07000086,EASTLEIGH,61102,60901,97.0,75.0,72.3,13.7,24.5,0.0,0.1,0.4,2.7,0.0,98.4,0.0,59262,45829,44148,8370,14947,6,31,218,1639,4,60146,0,15114,44148,6,25,187,1421,24.7,72.3,0.0,0.0,0.3,2.3
E07000030,EDEN,29986,29553,81.0,5.5,5.5,5.5,5.5,3.8,7.3,9.9,17.5,1.9,94.4,10.9,24294,1661,1661,1661,1661,1141,2182,2964,5259,567,28305,3258,22633,1661,1141,1041,782,2295,75.5,5.5,3.8,3.5,2.6,7.7
E07000207,ELMBRIDGE,61093,60899,98.5,78.1,75.4,8.3,8.3,0.0,0.1,0.1,1.1,0.0,99.2,0.0,60202,47685,46067,5048,5056,28,41,64,697,25,60624,0,14135,46067,28,13,23,633,23.1,75.4,0.0,0.0,0.0,1.0
E09000010,ENFIELD,133373,132229,97.1,88.1,87.0,3.7,86.4,0.0,0.1,0.7,2.1,0.0,97.4,0.0,129486,117547,116057,4915,115198,30,151,919,2743,52,129941,0,13429,116057,30,121,768,1824,10.1,87.0,0.0,0.1,0.6,1.4
E07000072,EPPING FOREST,61265,61022,94.9,76.7,74.9,16.4,72.5,0.2,0.5,1.2,4.7,0.4,96.8,1.5,58128,46996,45912,10075,44397,100,328,745,2894,255,59313,949,12216,45912,100,228,417,2149,19.9,74.9,0.2,0.4,0.7,3.5
E07000208,EPSOM AND EWELL,33318,33267,99.4,88.7,88.6,67.2,67.3,0.0,0.2,0.2,0.5,0.1,99.6,0.0,33117,29568,29508,22402,22432,0,52,55,150,22,33171,0,3609,29508,0,52,3,95,10.8,88.6,0.0,0.2,0.0,0.3
E07000036,EREWASH,55853,55650,98.1,78.5,77.0,26.7,26.7,0.2,0.3,0.4,1.5,0.0,99.4,0.0,54815,43868,42990,14940,14940,135,178,217,835,13,55519,0,11825,42990,135,43,39,618,21.2,77.0,0.2,0.1,0.1,1.1
E07000041,EXETER,58462,58076,95.8,87.1,86.9,62.6,62.6,0.1,0.2,1.4,3.6,0.0,96.4,33.6,55982,50941,50792,36598,36598,32,110,807,2094,10,56367,19657,5190,50792,32,78,697,1287,8.9,86.9,0.1,0.1,1.2,2.2
S12000014,FALKIRK,73925,73873,97.0,85.8,85.6,10.6,85.5,0.1,0.4,0.9,2.9,0.2,98.8,0.0,71718,63453,63310,7827,63235,49,262,652,2155,141,73006,0,8408,63310,49,213,390,1503,11.4,85.6,0.1,0.3,0.5,2.0
E07000087,FAREHAM,52692,52615,97.9,85.3,82.6,3.7,3.7,0.1,0.2,0.6,1.9,0.0,99.1,0.0,51608,44955,43527,1929,1973,48,97,304,1007,1,52206,0,8081,43527,48,49,207,703,15.3,82.6,0.1,0.1,0.4,1.3
E07000010,FENLAND,48174,47974,95.0,59.5,59.3,30.5,30.5,0.3,0.9,1.4,4.6,0.4,98.5,5.8,45756,28668,28545,14695,14695,150,434,698,2218,207,47465,2786,17211,28545,150,284,264,1520,35.7,59.3,0.3,0.6,0.5,3.2
N09000006,FERMANAGH AND OMAGH,50031,49147,69.5,33.4,33.4,33.4,33.4,8.3,13.6,18.1,28.7,5.9,96.9,39.9,34784,16730,16730,16730,16730,4141,6780,9055,14363,2945,48498,19961,18054,16730,4141,2639,2275,5308,36.1,33.4,8.3,5.3,4.5,10.6
S12000047,FIFE,191254,190186,95.6,54.0,53.3,25.2,25.2,0.3,0.8,1.4,3.9,0.3,98.5,0.0,182758,103228,101896,48123,48123,528,1455,2700,7428,489,188445,0,80862,101896,528,927,1245,4728,42.3,53.3,0.3,0.5,0.7,2.5
W06000005,FLINTSHIRE,74226,73912,94.5,43.3,37.0,33.6,33.6,0.4,1.1,2.4,5.1,0.8,97.4,39.6,70120,32112,27491,24942,24942,268,831,1787,3792,570,72280,29364,42629,27491,268,563,956,2005,57.4,37.0,0.4,0.8,1.3,2.7
E07000112,FOLKESTONE AND HYTHE,54431,54258,93.8,52.0,51.9,16.2,16.2,0.4,1.0,2.2,5.8,0.3,98.0,12.6,51076,28331,28240,8835,8835,227,557,1185,3182,141,53326,6851,22836,28240,227,330,628,1997,42.0,51.9,0.4,0.6,1.2,3.7
E07000080,FOREST OF DEAN,41675,41402,81.7,28.9,26.9,25.5,25.5,0.6,3.0,7.1,17.6,2.0,89.0,0.6,34061,12027,11201,10639,10639,245,1248,2959,7341,854,37106,258,22860,11201,245,1003,1711,4382,54.9,26.9,0.6,2.4,4.1,10.5
E07000119,FYLDE,36408,36147,93.9,45.1,33.9,5.7,5.7,0.1,0.3,0.8,5.4,0.0,98.0,21.6,34180,16434,12337,2063,2085,28,121,289,1967,4,35692,7855,21843,12337,28,93,168,1678,60.0,33.9,0.1,0.3,0.5,4.6
E08000037,GATESHEAD,101071,100543,95.7,71.6,70.1,5.9,5.9,0.1,0.3,1.0,3.8,0.0,97.2,0.0,96695,72349,70803,6000,6000,57,283,997,3848,48,98286,2,25892,70803,57,226,714,2851,25.6,70.1,0.1,0.2,0.7,2.8
E07000173,GEDLING,55318,55202,98.6,88.5,87.5,37.0,37.0,0.1,0.3,0.3,1.2,0.1,99.6,0.0,54559,48945,48415,20472,20472,35,140,182,643,33,55089,0,6144,48415,35,105,42,461,11.1,87.5,0.1,0.2,0.1,0.8
S12000049,GLASGOW CITY,336522,334708,97.0,74.2,68.3,22.1,64.1,0.0,0.0,0.2,2.5,0.0,97.3,0.0,326297,249562,229783,74237,215576,44,145,752,8411,5,327451,0,96514,229783,44,101,607,7659,28.7,68.3,0.0,0.0,0.2,2.3
E07000081,GLOUCESTER,60219,60123,98.1,88.2,86.3,8.4,8.4,0.0,0.4,0.9,1.7,0.0,98.5,0.0,59095,53123,51980,5046,5046,1,226,539,1028,11,59287,2,7115,51980,1,225,313,489,11.8,86.3,0.0,0.4,0.5,0.8
E07000088,GOSPORT,38909,38867,99.5,87.3,87.3,4.3,4.3,0.0,0.0,0.0,0.4,0.0,99.8,0.0,38726,33977,33960,1686,1686,1,11,16,141,0,38839,0,4766,33960,1,10,5,125,12.2,87.3,0.0,0.0,0.0,0.3
E07000109,GRAVESHAM,45270,45044,96.4,77.2,72.0,15.2,15.2,0.1,0.3,0.5,3.1,0.1,98.5,0.0,43647,34940,32600,6865,6865,27,134,226,1397,60,44580,0,11047,32600,27,107,92,1171,24.4,72.0,0.1,0.2,0.2,2.6
E07000145,GREAT YARMOUTH,49284,49043,97.1,51.7,51.7,4.9,4.9,0.0,0.1,0.4,2.4,0.1,99.2,0.0,47860,25471,25460,2436,2437,15,66,191,1183,65,48877,0,22400,25460,15,51,125,992,45.5,51.7,0.0,0.1,0.3,2.0
E09000011,GREENWICH,125263,124735,98.1,82.0,78.9,22.5,77.3,0.0,0.1,0.4,1.5,0.0,98.2,0.0,122852,102658,98819,28199,96867,0,152,557,1883,0,122986,2,24033,98819,0,152,405,1326,19.2,78.9,0.0,0.1,0.3,1.1
E07000209,GUILDFORD,59102,58555,95.7,67.7,64.4,3.1,3.1,0.0,0.2,0.7,3.4,0.3,98.2,0.0,56537,39984,38043,1818,1819,24,123,426,2018,155,58066,0,18494,38043,24,99,303,1592,31.3,64.4,0.0,0.2,0.5,2.7
W06000002,GWYNEDD,67964,67390,87.5,19.1,17.5,16.5,16.5,1.3,3.3,5.7,11.7,2.2,93.1,17.7,59458,13007,11888,11218,11218,878,2256,3904,7932,1472,63275,12012,47570,11888,878,1378,1648,4028,70.0,17.5,1.3,2.0,2.4,5.9
E09000012,HACKNEY,126201,125217,96.5,76.2,71.9,25.7,69.1,0.0,0.0,0.2,2.7,0.0,96.6,0.0,121838,96116,90713,32422,87151,0,0,225,3379,2,121893,0,31125,90713,0,0,225,3154,24.7,71.9,0.0,0.0,0.2,2.5
E06000006,HALTON,62578,61747,97.0,67.0,66.3,4.0,4.8,0.0,0.1,0.3,1.7,0.0,98.2,0.0,60698,41897,41464,2527,2980,17,85,195,1049,2,61476,0,19234,41464,17,68,110,854,30.7,66.3,0.0,0.1,0.2,1.4
E07000164,HAMBLETON,44899,44596,89.7,8.3,7.6,7.2,7.2,1.4,3.2,5.0,9.6,1.0,97.4,46.1,40272,3707,3391,3247,3247,634,1433,2251,4324,427,43718,20707,36881,3391,634,799,818,2073,82.1,7.6,1.4,1.8,1.8,4.6
E09000013,HAMMERSMITH AND FULHAM,92603,91845,94.3,72.2,60.5,30.5,50.9,0.0,0.1,0.3,4.8,0.0,94.3,0.0,87365,66825,56053,28259,47170,0,74,256,4480,0,87345,0,31312,56053,0,74,182,4224,33.8,60.5,0.0,0.1,0.2,4.6
E07000131,HARBOROUGH,43109,42940,95.3,45.0,39.5,17.8,17.8,0.3,0.7,1.4,4.4,0.5,98.5,0.0,41064,19418,17044,7664,7664,130,297,608,1876,208,42467,0,24020,17044,130,167,311,1268,55.7,39.5,0.3,0.4,0.7,2.9
E09000014,HARINGEY,109619,109435,98.3,84.0,82.4,4.4,81.0,0.0,0.0,0.3,1.5,0.0,98.4,0.0,107808,92049,90380,4796,88827,0,16,313,1627,0,107884,0,17428,90380,0,16,297,1314,15.9,82.4,0.0,0.0,0.3,1.2
E07000073,HARLOW,41609,41418,97.0,91.6,89.7,7.5,7.5,0.0,0.1,1.1,2.5,0.0,97.2,0.0,40375,38107,37324,3121,3121,1,35,439,1043,8,40428,0,3051,37324,1,34,404,604,7.3,89.7,0.0,0.1,1.0,1.5
E07000165,HARROGATE,78378,77929,92.3,57.3,55.3,21.8,21.8,0.7,1.7,2.6,7.1,0.7,97.2,14.2,72342,44896,43378,17048,17087,581,1333,2016,5587,510,76203,11159,28964,43378,581,752,683,3571,37.0,55.3,0.7,1.0,0.9,4.6
E09000015,HARROW,99637,99305,97.6,80.8,80.6,15.4,80.6,0.0,0.1,0.5,2.1,0.0,97.7,0.0,97214,80546,80321,15302,80320,14,51,472,2091,23,97318,0,16893,80321,14,37,421,1619,17.0,80.6,0.0,0.0,0.4,1.6
E07000089,HART,43960,43564,95.0,62.1,62.0,9.0,9.0,0.1,0.5,0.9,4.1,0.2,98.2,0.0,41741,27287,27254,3972,3972,33,238,393,1823,70,43170,1,14487,27254,33,205,155,1430,33.0,62.0,0.1,0.5,0.4,3.3
E06000001,HARTLEPOOL,47502,47057,95.7,88.0,87.8,5.3,5.3,0.3,0.6,1.2,3.4,0.2,96.3,0.6,45459,41806,41692,2522,2522,142,266,569,1598,100,45735,300,3767,41692,142,124,303,1029,7.9,87.8,0.3,0.3,0.6,2.2
E07000062,HASTINGS,46175,45912,98.4,4.5,4.5,4.5,4.5,0.0,0.0,0.1,1.1,0.0,99.3,0.0,45418,2062,2062,2062,2062,0,5,27,494,3,45863,0,43356,2062,0,5,22,467,93.9,4.5,0.0,0.0,0.0,1.0
E07000090,HAVANT,58077,57868,98.9,85.9,85.8,1.4,1.4,0.0,0.0,0.1,0.8,0.0,99.3,0.0,57420,49888,49857,840,840,0,26,71,448,5,57664,0,7563,49857,0,26,45,377,13.0,85.8,0.0,0.0,0.1,0.6
E09000016,HAVERING,113706,112404,95.8,83.7,81.8,4.7,80.4,0.1,0.2,0.6,3.1,0.8,96.6,0.0,108881,95130,92998,5295,91405,57,190,717,3523,859,109834,0,15883,92998,57,133,527,2806,14.0,81.8,0.1,0.1,0.5,2.5
E06000019,"HEREFORDSHIRE, COUNTY OF",90682,90006,88.5,28.3,23.9,20.9,20.9,1.0,2.6,4.7,10.8,1.9,95.2,3.3,80229,25699,21711,18948,18948,868,2334,4246,9777,1720,86303,3007,58518,21711,868,1466,1912,5531,64.5,23.9,1.0,1.6,2.1,6.1
E07000098,HERTSMERE,46713,46499,97.8,83.2,80.8,7.2,7.2,0.0,0.2,0.4,1.7,0.0,98.7,0.0,45692,38886,37760,3349,3349,5,87,167,807,14,46129,0,7932,37760,5,82,80,640,17.0,80.8,0.0,0.2,0.2,1.4
E07000037,HIGH PEAK,46200,45899,93.0,11.2,7.7,4.2,4.2,0.4,0.7,1.3,6.4,0.6,98.5,0.0,42943,5171,3544,1918,1918,185,340,586,2956,258,45487,1,39399,3544,185,155,246,2370,85.3,7.7,0.4,0.3,0.5,5.1
S12000017,HIGHLAND,115692,113073,81.9,15.9,15.9,15.9,15.9,2.3,4.6,7.6,15.8,4.3,93.2,4.6,94741,18359,18359,18359,18359,2631,5283,8843,18332,4984,107804,5371,76382,18359,2631,2652,3560,9489,66.0,15.9,2.3,2.3,3.1,8.2
E09000017,HILLINGDON,120720,119736,95.8,86.1,85.1,16.4,84.3,0.0,0.2,0.8,3.4,0.0,96.0,0.0,115684,103964,102777,19765,101820,49,254,973,4052,15,115942,0,12907,102777,49,205,719,3079,10.7,85.1,0.0,0.2,0.6,2.6
E07000132,HINCKLEY AND BOSWORTH,54610,54189,96.4,64.4,61.5,8.9,8.9,0.1,0.9,1.2,2.8,0.3,98.1,0.0,52668,35160,33567,4872,4874,49,509,668,1521,160,53577,0,19101,33567,49,460,159,853,35.0,61.5,0.1,0.8,0.3,1.6
E07000227,HORSHAM,67251,66845,93.1,40.0,35.1,31.1,31.1,0.4,1.1,1.9,6.3,0.7,98.4,0.0,62625,26889,23615,20902,20902,246,719,1278,4220,495,66197,0,39010,23615,246,473,559,2942,58.0,35.1,0.4,0.7,0.8,4.4
E09000018,HOUNSLOW,101282,100487,96.1,84.5,84.3,9.8,84.3,0.0,0.2,0.9,3.1,0.1,96.2,0.0,97332,85619,85387,9943,85336,0,155,887,3155,108,97409,0,11945,85387,0,155,732,2268,11.8,84.3,0.0,0.2,0.7,2.2
E07000011,HUNTINGDONSHIRE,83695,83024,96.2,58.6,54.4,9.6,9.6,0.3,0.7,1.2,3.0,0.3,98.5,0.4,80536,49069,45514,8056,8056,235,553,963,2488,213,82481,323,35022,45514,235,318,410,1525,41.8,54.4,0.3,0.4,0.5,1.8
E07000120,HYNDBURN,41310,40823,97.3,76.9,69.8,17.3,17.4,0.0,0.1,0.2,1.5,0.0,98.6,85.0,40187,31749,28838,7137,7170,17,35,80,636,1,40742,35106,11349,28838,17,18,45,556,27.5,69.8,0.0,0.0,0.1,1.3
S12000018,INVERCLYDE,42009,41959,96.7,73.3,73.0,10.3,10.3,0.1,0.4,0.7,3.2,0.2,98.4,0.0,40624,30812,30655,4311,4311,41,148,291,1335,69,41347,0,9969,30655,41,107,143,1044,23.7,73.0,0.1,0.3,0.3,2.5
E07000202,IPSWICH,65341,65161,98.1,87.5,84.5,19.4,19.4,0.0,0.1,0.4,1.6,0.0,98.4,0.0,64094,57192,55223,12677,12677,0,40,247,1067,4,64269,0,8871,55223,0,40,207,820,13.6,84.5,0.0,0.1,0.3,1.3
W06000001,ISLE OF ANGLESEY,37454,36953,88.8,16.8,16.8,16.8,16.8,0.8,2.0,3.6,9.9,1.7,94.7,25.3,33256,6278,6278,6278,6278,295,759,1344,3697,620,35478,9459,26978,6278,295,464,585,2353,72.0,16.8,0.8,1.2,1.6,6.3
E06000046,ISLE OF WIGHT,78433,77959,93.4,34.1,34.1,34.1,34.1,0.3,0.7,1.3,6.0,0.3,99.1,0.0,73219,26722,26722,26722,26722,229,565,1027,4740,270,77763,0,46497,26722,229,336,462,3713,59.3,34.1,0.3,0.4,0.6,4.7
E06000053,ISLES OF SCILLY,1682,1661,94.5,0.0,0.0,0.0,0.0,0.0,0.0,0.2,4.2,0.1,98.8,0.0,1590,0,0,0,0,0,0,4,71,2,1661,0,1590,0,0,0,4,67,94.5,0.0,0.0,0.0,0.2,4.0
E09000019,ISLINGTON,118703,118294,94.8,81.5,80.5,20.1,80.5,0.0,0.0,0.1,4.8,0.0,94.8,0.0,112567,96735,95613,23819,95615,0,0,70,5727,1,112575,0,16954,95613,0,0,70,5657,14.3,80.5,0.0,0.0,0.1,4.8
E09000020,KENSINGTON AND CHELSEA,98311,98085,96.0,88.2,84.6,27.6,82.1,0.0,0.0,0.1,3.8,0.0,96.0,0.0,94389,86713,83180,27109,80688,0,0,54,3696,0,94389,0,11209,83180,0,0,54,3642,11.4,84.6,0.0,0.0,0.1,3.7
E07000146,"KING'S LYNN AND WEST NORFOLK",78908,78129,91.9,12.6,8.3,4.9,4.9,0.4,1.1,2.2,7.1,0.9,97.6,3.1,72538,9948,6520,3852,3852,340,891,1702,5591,747,77041,2408,66018,6520,340,551,811,3889,83.7,8.3,0.4,0.7,1.0,4.9
E06000010,"KINGSTON UPON HULL, CITY OF",128932,126957,98.4,97.5,97.5,97.5,97.5,0.0,0.0,0.0,0.0,0.0,98.4,21.1,126927,125736,125736,125736,125736,1,1,11,30,4,126927,27206,1191,125736,1,0,10,19,0.9,97.5,0.0,0.0,0.0,0.0
E09000021,KINGSTON UPON THAMES,70701,70468,98.0,90.5,87.0,4.0,84.9,0.0,0.0,0.1,1.7,0.0,98.2,0.0,69257,63971,61498,2815,60015,0,3,81,1211,1,69399,0,7759,61498,0,3,78,1130,11.0,87.0,0.0,0.0,0.1,1.6
E08000034,KIRKLEES,197525,196854,97.0,74.4,74.2,34.1,34.4,0.0,0.2,0.5,2.7,0.0,98.7,0.0,191590,146978,146591,67431,67995,76,335,958,5264,36,194911,0,44999,146591,76,259,623,4306,22.8,74.2,0.0,0.1,0.3,2.2
E08000011,KNOWSLEY,73222,73049,98.5,79.0,75.0,11.8,74.9,0.0,0.2,0.2,1.3,0.0,99.3,0.0,72110,57846,54881,8646,54861,15,119,181,939,25,72716,0,17229,54881,15,104,62,758,23.5,75.0,0.0,0.1,0.1,1.0
E09000022,LAMBETH,154141,153154,95.9,75.7,70.5,17.2,67.3,0.0,0.0,0.0,3.4,0.0,96.1,0.0,147866,116717,108699,26440,103773,0,0,6,5288,3,148070,0,39167,108699,0,0,6,5282,25.4,70.5,0.0,0.0,0.0,3.4
E07000121,LANCASTER,68007,67740,97.8,63.4,54.0,16.4,16.4,0.2,0.3,0.5,1.9,0.1,99.3,2.0,66479,43131,36696,11138,11138,141,203,351,1261,54,67551,1371,29783,36696,141,62,148,910,43.8,54.0,0.2,0.1,0.2,1.3
E08000035,LEEDS,377805,376392,96.6,85.5,83.6,53.9,82.6,0.0,0.2,0.5,3.0,0.1,97.3,6.2,365006,323082,315809,203753,311905,105,875,1853,11386,228,367624,23321,49197,315809,105,770,978,9533,13.0,83.6,0.0,0.2,0.3,2.5
E06000016,LEICESTER,145513,145054,98.4,91.5,90.4,14.9,14.9,0.0,0.0,0.2,1.3,0.0,98.5,0.0,143142,133174,131512,21626,21627,22,61,272,1912,15,143382,0,11630,131512,22,39,211,1640,8.0,90.4,0.0,0.0,0.1,1.1
E07000063,LEWES,47659,47477,96.7,25.5,25.2,25.4,25.4,0.1,0.3,0.5,2.9,0.2,99.4,0.0,46084,12145,12019,12112,12112,34,121,230,1393,78,47365,0,34065,12019,34,87,109,1163,71.5,25.2,0.1,0.2,0.2,2.4
E09000023,LEWISHAM,138212,137331,95.3,67.4,65.9,17.2,65.0,0.0,0.0,0.2,4.1,0.0,95.5,0.0,131677,93198,91061,23765,89876,0,0,307,5654,0,131960,0,40616,91061,0,0,307,5347,29.4,65.9,0.0,0.0,0.2,3.9
E07000194,LICHFIELD,49094,48883,95.8,70.0,65.8,17.9,62.7,0.3,0.6,1.2,3.7,0.2,99.2,0.0,47048,34366,32291,8808,30762,142,289,586,1835,74,48706,0,14757,32291,142,147,297,1249,30.1,65.8,0.3,0.3,0.6,2.5
E07000138,LINCOLN,48273,48176,98.0,82.1,81.1,2.3,2.3,0.0,0.1,0.5,1.8,0.0,98.3,23.9,47295,39619,39172,1128,1128,14,33,248,881,15,47439,11544,8123,39172,14,19,215,633,16.8,81.1,0.0,0.0,0.4,1.3
N09000007,LISBURN AND CASTLEREAGH,60283,59703,92.9,78.2,78.1,67.0,78.2,0.3,1.3,2.1,6.1,0.9,98.3,0.0,56026,47119,47057,40418,47118,183,782,1290,3677,551,59249,0,8969,47057,183,599,508,2387,14.9,78.1,0.3,1.0,0.8,4.0
E08000012,LIVERPOOL,235808,234637,94.7,81.5,79.0,36.7,77.3,0.0,0.0,0.4,4.8,0.0,95.0,0.0,223275,192207,186337,86538,182337,4,49,840,11362,8,224129,2,36938,186337,4,45,791,10522,15.7,79.0,0.0,0.0,0.3,4.5
E06000032,LUTON,86288,85927,98.6,93.2,91.2,1.8,1.8,0.1,0.3,0.5,1.0,0.0,98.7,0.0,85068,80391,78678,1516,1516,48,296,446,859,0,85151,0,6390,78678,48,248,150,413,7.4,91.2,0.1,0.3,0.2,0.5
E07000110,MAIDSTONE,78549,78116,92.4,71.7,67.2,26.6,26.6,0.5,1.4,2.2,7.0,0.6,97.6,29.1,72594,56299,52762,20880,20880,395,1075,1741,5522,481,76675,22855,19832,52762,395,680,666,3781,25.2,67.2,0.5,0.9,0.8,4.8
E07000074,MALDON,30268,30130,94.5,31.0,31.0,31.0,31.0,0.3,0.9,1.9,5.0,0.6,98.7,5.8,28615,9387,9387,9387,9387,100,287,568,1515,193,29876,1763,19228,9387,100,187,281,947,63.5,31.0,0.3,0.6,0.9,3.1
E07000235,MALVERN HILLS,38483,38251,90.2,25.3,18.2,13.8,13.8,0.5,1.8,3.4,9.2,0.9,97.5,6.2,34716,9748,7022,5312,5312,180,687,1318,3535,361,37517,2405,27694,7022,180,507,631,2217,72.0,18.2,0.5,1.3,1.6,5.8
E08000003,MANCHESTER,248015,242883,93.0,75.2,71.9,29.0,63.8,0.0,0.1,0.9,5.0,0.0,93.3,0.0,230600,186465,178261,71817,158112,30,280,2159,12283,0,231440,1,52339,178261,30,250,1879,10124,21.1,71.9,0.0,0.1,0.8,4.1
E07000174,MANSFIELD,53018,52901,98.7,88.3,85.6,9.0,9.0,0.0,0.2,0.3,1.1,0.1,99.3,0.0,52310,46808,45377,4783,4783,5,82,149,591,60,52645,0,6933,45377,5,77,67,442,13.1,85.6,0.0,0.1,0.1,0.8
E06000035,MEDWAY,122144,121751,97.3,84.6,81.5,8.5,8.5,0.0,0.3,0.7,2.3,0.1,98.6,2.8,118890,103277,99505,10438,10438,36,314,859,2861,113,120456,3456,19385,99505,36,278,545,2002,15.9,81.5,0.0,0.2,0.4,1.6
E07000133,MELTON,24747,24613,93.3,46.7,46.2,2.2,2.2,0.8,1.9,3.1,6.2,1.2,96.8,5.7,23087,11545,11429,556,556,198,477,759,1526,306,23966,1405,11658,11429,198,279,282,767,47.1,46.2,0.8,1.1,1.1,3.1
E07000187,MENDIP,55863,55640,87.3,49.0,43.9,22.6,22.6,0.5,2.0,4.8,12.3,0.8,94.4,14.7,48759,27379,24527,12647,12647,265,1092,2699,6881,443,52757,8210,24232,24527,265,827,1607,4182,43.4,43.9,0.5,1.5,2.9,7.5
W06000024,MERTHYR TYDFIL,28469,28390,98.5,34.3,34.3,34.3,34.3,0.1,0.3,0.4,1.3,0.0,99.5,10.1,28028,9779,9779,9779,9779,39,72,122,362,5,28327,2883,18249,9779,39,33,50,240,64.1,34.3,0.1,0.1,0.2,0.8
E09000024,MERTON,89859,89743,98.4,88.8,87.0,31.2,87.0,0.0,0.0,0.2,1.5,0.0,98.4,0.0,88423,79802,78179,28011,78170,1,36,191,1320,1,88454,0,10244,78179,1,35,155,1129,11.4,87.0,0.0,0.0,0.2,1.3
N09000008,MID AND EAST ANTRIM,61733,61044,89.7,71.1,70.8,71.1,71.1,1.9,3.4,4.5,9.2,1.9,97.8,0.0,55395,43870,43729,43869,43870,1198,2072,2800,5649,1165,60372,0,11666,43729,1198,874,728,2849,18.9,70.8,1.9,1.4,1.2,4.6
E07000042,MID DEVON,37620,37325,78.4,9.0,9.0,9.0,9.0,1.8,5.8,10.4,20.8,3.1,91.7,11.7,29489,3402,3402,3400,3400,685,2170,3894,7836,1152,34484,4386,26087,3402,685,1485,1724,3942,69.3,9.0,1.8,3.9,4.6,10.5
E07000203,MID SUFFOLK,48341,47907,92.4,17.5,16.3,15.7,15.7,0.4,0.8,1.7,6.7,0.7,98.1,3.7,44658,8479,7871,7573,7573,181,409,833,3249,357,47409,1807,36787,7871,181,228,424,2416,76.1,16.3,0.4,0.5,0.9,5.0
E07000228,MID SUSSEX,68440,68081,95.7,36.2,34.2,33.0,33.0,0.0,0.2,0.7,3.8,0.3,99.0,0.0,65488,24805,23437,22582,22582,30,159,503,2593,225,67734,0,42051,23437,30,129,344,2090,61.4,34.2,0.0,0.2,0.5,3.1
N09000009,MID ULSTER,55398,54582,80.5,47.1,47.1,47.1,47.1,3.5,6.4,9.3,18.1,5.9,97.5,4.5,44572,26113,26112,26112,26112,1921,3540,5125,10010,3249,54008,2489,18460,26112,1921,1619,1585,4885,33.3,47.1,3.5,2.9,2.9,8.8
E06000002,MIDDLESBROUGH,68012,67881,96.9,92.0,91.7,5.6,5.6,0.1,0.5,1.0,2.9,0.1,97.2,2.4,65913,62559,62353,3821,3821,66,326,649,1968,57,66090,1656,3560,62353,66,260,323,1319,5.2,91.7,0.1,0.4,0.5,1.9
S12000019,MIDLOTHIAN,42306,41910,93.6,48.5,48.2,48.5,48.5,0.7,1.4,2.5,5.4,0.6,97.7,4.8,39610,20534,20378,20519,20533,288,582,1040,2300,236,41330,2010,19232,20378,288,294,458,1260,45.5,48.2,0.7,0.7,1.1,3.0
E06000042,MILTON KEYNES,122303,121859,98.0,89.0,87.9,87.0,87.0,0.1,0.3,1.0,1.7,0.2,98.6,0.0,119834,108879,107462,106398,106401,76,374,1186,2025,225,120592,1,12372,107462,76,298,812,839,10.1,87.9,0.1,0.2,0.7,0.7
E07000210,MOLE VALLEY,39973,39863,95.7,61.7,61.7,10.7,10.7,0.0,0.3,0.7,4.0,0.4,99.2,0.0,38256,24657,24649,4266,4266,15,101,298,1607,143,39651,0,13607,24649,15,86,197,1309,34.0,61.7,0.0,0.2,0.5,3.3
W06000021,MONMOUTHSHIRE,45242,44913,86.6,27.0,17.7,11.6,11.6,1.4,3.4,6.2,12.7,2.7,95.4,0.2,39189,12193,8014,5251,5251,629,1526,2785,5724,1236,43169,80,31175,8014,629,897,1259,2939,68.9,17.7,1.4,2.0,2.8,6.5
S12000020,MORAY,49519,49068,84.8,16.8,16.8,16.8,16.8,1.7,4.5,7.0,14.3,3.1,95.2,34.2,42007,8342,8342,8342,8342,842,2232,3473,7061,1552,47164,16929,33665,8342,842,1390,1241,3588,68.0,16.8,1.7,2.8,2.5,7.2
S12000013,NA H-EILEANAN SIAR,16680,15204,76.9,4.5,4.5,4.5,4.5,2.5,3.8,5.1,14.3,6.9,87.9,0.0,12821,744,744,744,744,415,641,848,2383,1151,14665,0,12077,744,415,226,207,1535,72.4,4.5,2.5,1.4,1.2,9.2
W06000012,NEATH PORT TALBOT,68958,68854,97.0,59.1,59.1,4.2,29.7,0.1,0.2,0.4,2.8,0.2,99.1,32.6,66905,40742,40730,2882,20507,56,146,286,1949,114,68342,22487,26175,40730,56,90,140,1663,38.0,59.1,0.1,0.1,0.2,2.4
E07000091,NEW FOREST,87569,87118,93.5,27.2,24.5,11.1,11.2,0.4,0.8,1.4,6.0,0.8,98.6,0.1,81865,23822,21438,9724,9766,394,668,1225,5253,671,86369,87,60427,21438,394,274,557,4028,69.0,24.5,0.4,0.3,0.6,4.6
E07000175,NEWARK AND SHERWOOD,59826,59347,95.2,54.8,54.3,14.7,14.7,0.3,0.9,1.5,4.0,0.3,98.0,0.0,56931,32756,32491,8788,8789,156,547,880,2416,202,58603,16,24440,32491,156,391,333,1536,40.9,54.3,0.3,0.7,0.6,2.6
E08000021,NEWCASTLE UPON TYNE,138792,137985,96.0,73.6,69.8,28.6,28.6,0.0,0.1,0.2,3.4,0.0,96.7,0.0,133205,102119,96943,39732,39732,64,149,323,4780,20,134173,55,36262,96943,64,85,174,4457,26.1,69.8,0.0,0.1,0.1,3.2
E07000195,NEWCASTLE-UNDER-LYME,61114,60354,95.7,66.9,65.6,12.2,12.2,0.0,0.3,0.7,3.1,0.1,97.9,2.1,58479,40867,40120,7472,7472,23,210,453,1875,80,59859,1272,18359,40120,23,187,243,1422,30.0,65.6,0.0,0.3,0.4,2.3
E09000025,NEWHAM,128066,127665,98.0,89.9,86.3,55.0,82.7,0.0,0.1,0.6,1.7,0.0,98.0,0.0,125443,115154,110542,70393,105879,12,152,794,2222,16,125457,0,14901,110542,12,140,642,1428,11.6,86.3,0.0,0.1,0.5,1.1
W06000022,NEWPORT,72528,72301,97.1,73.6,70.4,9.1,9.1,0.1,0.3,0.7,2.6,0.2,98.0,34.1,70430,53385,51090,6602,6602,71,242,519,1871,132,71092,24734,19340,51090,71,171,277,1352,26.7,70.4,0.1,0.2,0.4,1.9
N09000010,"NEWRY, MOURNE AND DOWN",70659,69191,84.1,61.2,61.1,61.2,61.2,2.6,4.9,6.8,13.8,4.1,97.2,3.3,59440,43261,43143,43261,43261,1833,3450,4837,9751,2883,68668,2307,16297,43143,1833,1617,1387,4914,23.1,61.1,2.6,2.3,2.0,7.0
S12000021,NORTH AYRSHIRE,72069,71869,94.4,31.5,31.5,14.0,14.0,0.4,0.9,1.7,5.3,0.4,98.8,0.0,68020,22720,22713,10068,10068,311,623,1230,3849,255,71179,0,45307,22713,311,312,607,2619,62.9,31.5,0.4,0.4,0.8,3.6
E07000043,NORTH DEVON,51567,51149,86.7,20.3,20.3,20.3,20.3,1.5,3.4,6.3,12.5,1.7,93.7,53.2,44710,10451,10451,10451,10451,763,1744,3244,6439,878,48316,27443,34259,10451,763,981,1500,3195,66.4,20.3,1.5,1.9,2.9,6.2
E07000038,NORTH EAST DERBYSHIRE,48744,48565,94.2,35.7,33.6,32.2,32.2,0.3,0.7,1.2,5.4,0.2,99.0,0.0,45911,17415,16363,15686,15686,157,362,583,2654,74,48239,0,29548,16363,157,205,221,2071,60.6,33.6,0.3,0.4,0.5,4.2
E06000012,NORTH EAST LINCOLNSHIRE,74220,74074,96.8,88.9,88.5,1.5,1.5,0.1,0.9,1.3,3.0,0.2,97.6,25.8,71856,66008,65672,1083,1083,70,631,953,2218,155,72453,19123,6184,65672,70,561,322,1265,8.3,88.5,0.1,0.8,0.4,1.7
E07000099,NORTH HERTFORDSHIRE,61067,60853,96.3,74.0,72.7,4.9,4.9,0.1,0.3,0.8,3.3,0.2,98.1,0.2,58815,45203,44381,2972,2972,40,189,487,2038,147,59920,102,14434,44381,40,149,298,1551,23.6,72.7,0.1,0.2,0.5,2.5
E07000139,NORTH KESTEVEN,54892,54584,94.1,37.3,35.7,6.4,6.4,0.7,1.3,2.2,5.4,0.7,98.1,4.8,51639,20464,19594,3510,3510,379,731,1183,2945,369,53837,2658,32045,19594,379,352,452,1762,58.4,35.7,0.7,0.6,0.8,3.2
S12000050,NORTH LANARKSHIRE,165158,164884,97.9,78.4,77.1,13.0,77.0,0.1,0.3,0.6,1.9,0.1,99.1,0.0,161751,129426,127414,21409,127179,84,485,975,3133,215,163608,0,34337,127414,84,401,490,2158,20.8,77.1,0.1,0.2,0.3,1.3
E06000013,NORTH LINCOLNSHIRE,80742,80265,93.7,46.3,46.2,7.1,7.1,0.6,1.2,1.8,5.7,0.4,97.1,51.6,75673,37366,37342,5737,5737,469,976,1486,4592,324,78425,41684,38331,37342,469,507,510,3106,47.5,46.2,0.6,0.6,0.6,3.8
E07000147,NORTH NORFOLK,60687,60292,90.9,5.0,5.0,5.0,5.0,0.5,1.6,2.7,8.5,2.0,97.2,0.2,55137,3021,3021,3014,3014,316,959,1644,5155,1241,58958,103,52116,3021,316,643,685,3511,85.9,5.0,0.5,1.1,1.1,5.8
E06000061,NORTH NORTHAMPTONSHIRE,163034,162300,97.1,71.7,71.5,16.3,16.3,0.1,0.5,1.1,2.4,0.4,98.0,3.3,158370,116962,116517,26623,26623,138,845,1873,3930,632,159704,5419,41853,116517,138,707,1028,2057,25.7,71.5,0.1,0.4,0.6,1.3
E06000024,NORTH SOMERSET,103319,102483,92.8,57.6,51.0,28.4,28.4,0.2,0.6,1.3,6.4,0.2,96.2,0.0,95875,59561,52693,29366,29366,160,577,1337,6608,189,99393,0,43182,52693,160,417,760,5271,41.8,51.0,0.2,0.4,0.7,5.1
E08000022,NORTH TYNESIDE,102569,102321,98.7,78.7,75.0,27.9,27.9,0.0,0.2,0.4,1.0,0.1,99.2,0.0,101282,80728,76937,28604,28604,31,161,411,1039,53,101709,1,24345,76937,31,130,250,628,23.7,75.0,0.0,0.1,0.2,0.6
E07000218,NORTH WARWICKSHIRE,30508,30379,96.1,37.1,34.9,20.6,33.7,0.3,0.8,1.3,3.5,0.2,98.8,0.0,29313,11309,10645,6285,10279,79,253,406,1066,69,30152,0,18668,10645,79,174,153,660,61.2,34.9,0.3,0.6,0.5,2.2
E07000134,NORTH WEST LEICESTERSHIRE,48792,48650,96.7,69.7,67.9,6.6,6.6,0.2,0.7,1.2,3.0,0.2,98.8,0.0,47202,33984,33153,3208,3208,85,351,572,1448,94,48216,0,14049,33153,85,266,221,876,28.8,67.9,0.2,0.5,0.5,1.8
E06000057,NORTHUMBERLAND,158554,157968,93.1,15.2,9.8,6.4,6.4,0.9,1.7,2.5,6.6,0.9,98.5,4.1,147572,24120,15502,10225,10225,1371,2655,3903,10396,1365,156190,6560,132070,15502,1371,1284,1248,6493,83.3,9.8,0.9,0.8,0.8,4.1
E07000148,NORWICH,58318,58098,98.3,85.7,82.9,10.1,10.1,0.0,0.0,0.4,1.3,0.0,98.6,0.0,57344,49952,48362,5861,5861,0,7,262,754,4,57513,0,8982,48362,0,7,255,492,15.4,82.9,0.0,0.0,0.4,0.8
E06000018,NOTTINGHAM,144401,143911,97.9,92.1,90.4,26.8,26.8,0.0,0.1,0.3,1.8,0.0,98.0,0.0,141357,132963,130544,38675,38675,14,100,405,2554,14,141527,0,10813,130544,14,86,305,2149,7.5,90.4,0.0,0.1,0.2,1.5
E07000219,NUNEATON AND BEDWORTH,60657,60485,98.5,82.0,81.3,10.6,81.9,0.0,0.2,0.4,1.2,0.0,99.2,0.0,59762,49713,49295,6449,49649,13,145,246,723,5,60150,0,10467,49295,13,132,101,477,17.3,81.3,0.0,0.2,0.2,0.8
E07000135,OADBY AND WIGSTON,25837,25488,97.2,77.1,74.2,1.5,1.5,0.0,0.0,0.2,1.5,0.0,97.7,0.0,25101,19932,19176,379,379,0,2,46,387,0,25247,0,5925,19176,0,2,44,341,22.9,74.2,0.0,0.0,0.2,1.3
E08000004,OLDHAM,98693,98434,98.3,79.0,78.4,20.0,20.1,0.1,0.1,0.3,1.5,0.0,99.5,0.0,96985,77964,77404,19699,19825,64,148,298,1449,7,98203,0,19581,77404,64,84,150,1151,19.8,78.4,0.1,0.1,0.2,1.2
S12000023,ORKNEY ISLANDS,12808,12222,65.0,1.1,1.1,1.1,1.1,3.9,9.1,20.0,30.5,9.1,76.5,0.0,8319,146,146,146,146,503,1162,2560,3903,1171,9800,0,8173,146,503,659,1398,1343,63.8,1.1,3.9,5.1,10.9,10.5
E07000178,OXFORD,65891,65340,97.2,83.9,77.9,1.1,1.1,0.0,0.0,0.4,2.0,0.0,97.3,0.0,64049,55299,51352,703,703,0,31,264,1291,16,64141,0,12697,51352,0,31,233,1027,19.3,77.9,0.0,0.0,0.4,1.6
W06000009,PEMBROKESHIRE,65855,65582,88.0,6.8,6.8,6.8,6.8,1.8,3.9,6.4,11.6,2.2,94.9,2.0,57953,4495,4495,4490,4495,1172,2576,4243,7629,1439,62466,1333,53458,4495,1172,1404,1667,3386,81.2,6.8,1.8,2.1,2.5,5.1
E07000122,PENDLE,44066,43748,95.9,52.8,52.4,1.7,52.0,0.4,0.9,1.2,3.4,0.2,98.4,53.7,42250,23257,23094,770,22908,175,390,550,1498,107,43350,23667,19156,23094,175,215,160,948,43.5,52.4,0.4,0.5,0.4,2.2
S12000048,PERTH AND KINROSS,78805,78166,85.4,36.1,35.2,5.7,5.7,1.7,4.2,7.1,13.8,2.4,95.0,0.0,67324,28420,27707,4481,4481,1328,3292,5617,10842,1912,74882,1,39617,27707,1328,1964,2325,5225,50.3,35.2,1.7,2.5,3.0,6.6
E06000031,PETERBOROUGH,92518,92314,98.1,85.1,84.6,72.4,72.4,0.1,0.3,0.5,1.7,0.1,99.0,0.0,90751,78716,78288,67013,67013,69,298,455,1563,83,91599,0,12463,78288,69,229,157,1108,13.5,84.6,0.1,0.2,0.2,1.2
E06000026,PLYMOUTH,123485,123178,97.4,88.8,87.5,2.8,2.8,0.0,0.2,0.8,2.4,0.0,97.8,27.0,120223,109593,108036,3452,3453,4,228,1045,2955,40,120745,33382,12187,108036,4,224,817,1910,9.9,87.5,0.0,0.2,0.7,1.5
E06000044,PORTSMOUTH,95682,95397,96.6,93.5,91.4,17.7,17.7,0.0,0.2,0.7,3.1,0.0,96.7,0.0,92448,89496,87409,16920,16920,23,168,622,2949,2,92566,0,5039,87409,23,145,454,2327,5.3,91.4,0.0,0.2,0.5,2.4
W06000023,POWYS,69522,68294,78.5,17.3,17.3,17.3,17.3,3.3,6.9,11.3,19.7,5.5,88.1,8.3,54567,12021,12020,12018,12018,2308,4825,7847,13727,3827,61222,5804,42547,12020,2308,2517,3022,5880,61.2,17.3,3.3,3.6,4.3,8.5
E07000123,PRESTON,67743,67415,97.3,71.5,69.2,6.4,6.4,0.0,0.1,0.4,2.2,0.0,98.6,62.9,65912,48418,46852,4354,4354,25,55,243,1503,21,66769,42621,19060,46852,25,30,188,1260,28.1,69.2,0.0,0.0,0.3,1.9
E06000038,READING,75278,74940,97.3,87.4,83.3,7.7,80.5,0.0,0.2,0.4,2.3,0.0,97.4,0.0,73214,65775,62715,5804,60632,20,145,336,1726,4,73347,0,10499,62715,20,125,191,1390,13.9,83.3,0.0,0.2,0.3,1.8
E09000026,REDBRIDGE,111163,110687,97.6,85.2,84.3,32.2,83.6,0.0,0.1,0.3,1.9,0.0,97.9,0.0,108521,94750,93681,35780,92967,8,99,334,2166,5,108798,1,14840,93681,8,91,235,1832,13.3,84.3,0.0,0.1,0.2,1.6
E06000003,REDCAR AND CLEVELAND,68368,68186,96.6,86.1,85.0,1.5,1.5,0.1,0.6,1.4,3.2,0.3,97.8,0.4,66031,58864,58097,1016,1016,100,420,951,2155,202,66851,287,7934,58097,100,320,531,1204,11.6,85.0,0.1,0.5,0.8,1.8
E07000236,REDDITCH,39527,39376,98.0,79.9,79.1,4.9,79.2,0.0,0.0,0.1,1.6,0.0,99.0,0.1,38740,31580,31285,1929,31288,2,13,49,636,6,39128,31,7455,31285,2,11,36,587,18.9,79.1,0.0,0.0,0.1,1.5
E07000211,REIGATE AND BANSTEAD,64336,64215,97.6,78.6,76.3,23.5,23.6,0.0,0.1,0.2,2.2,0.1,99.6,0.0,62787,50584,49116,15145,15154,17,86,146,1428,41,64100,0,13671,49116,17,69,60,1282,21.2,76.3,0.0,0.1,0.1,2.0
S12000038,RENFREWSHIRE,94962,94576,96.1,80.2,80.2,23.3,53.2,0.1,0.4,0.8,3.5,0.1,97.6,0.0,91215,76205,76118,22132,50540,109,333,741,3361,67,92673,0,15097,76118,109,224,408,2620,15.9,80.2,0.1,0.2,0.4,2.8
W06000016,RHONDDA CYNON TAF,119076,118283,97.3,24.5,21.1,11.6,18.9,0.0,0.1,0.4,2.0,0.1,98.7,26.9,115862,29220,25081,13783,22462,55,107,463,2421,168,117517,32059,90781,25081,55,52,356,1958,76.2,21.1,0.0,0.0,0.3,1.6
E07000124,RIBBLE VALLEY,30399,30205,90.6,24.7,24.4,23.4,23.7,0.7,2.1,3.6,8.8,0.6,98.2,81.1,27543,7520,7432,7115,7215,224,634,1098,2662,171,29837,24665,20111,7432,224,410,464,1564,66.2,24.4,0.7,1.3,1.5,5.1
E09000027,RICHMOND UPON THAMES,88841,88609,98.1,87.8,86.2,24.1,85.2,0.0,0.0,0.2,1.6,0.0,98.3,0.0,87186,77982,76595,21434,75729,0,18,201,1423,14,87315,0,10591,76595,0,18,183,1222,11.9,86.2,0.0,0.0,0.2,1.4
E07000166,RICHMONDSHIRE,25273,25011,84.8,24.8,13.2,5.7,5.7,2.3,4.8,7.7,14.2,2.9,95.7,36.8,21430,6259,3337,1428,1428,590,1224,1945,3581,725,24194,9296,18093,3337,590,634,721,1636,71.6,13.2,2.3,2.5,2.9,6.5
E08000005,ROCHDALE,101352,100924,97.5,71.1,62.2,11.0,11.0,0.0,0.1,0.4,2.1,0.1,99.0,0.0,98832,72048,63067,11111,11116,28,120,391,2092,51,100337,0,35765,63067,28,92,271,1701,35.3,62.2,0.0,0.1,0.3,1.7
E07000075,ROCHFORD,38046,37783,97.6,18.3,13.0,9.0,9.0,0.0,0.2,0.3,1.7,0.1,99.0,0.0,37141,6969,4947,3430,3430,2,67,129,642,43,37669,1,32194,4947,2,65,62,513,84.6,13.0,0.0,0.2,0.2,1.3
E07000125,ROSSENDALE,34989,34703,94.2,53.0,43.6,1.3,1.3,0.1,0.8,1.0,5.0,0.2,98.1,0.1,32943,18550,15245,467,467,33,265,344,1760,68,34339,50,17698,15245,33,232,79,1416,50.6,43.6,0.1,0.7,0.2,4.0
E07000064,ROTHER,49520,49090,93.9,7.3,7.3,7.3,7.3,0.1,0.3,1.0,5.2,0.2,98.8,0.7,46499,3610,3610,3610,3610,47,138,503,2591,111,48946,341,42889,3610,47,91,365,2088,86.6,7.3,0.1,0.2,0.7,4.2
E08000018,ROTHERHAM,124931,124535,98.0,62.7,60.4,17.3,17.3,0.0,0.2,0.5,1.7,0.1,99.1,0.4,122451,78382,75423,21639,21639,30,232,595,2084,115,123798,536,47028,75423,30,202,363,1489,37.6,60.4,0.0,0.2,0.3,1.2
E07000220,RUGBY,50726,50524,97.1,68.7,65.3,17.5,62.4,0.3,0.6,1.1,2.5,0.2,98.6,0.0,49242,34874,33121,8882,31632,154,327,551,1282,106,50037,3,16121,33121,154,173,224,731,31.8,65.3,0.3,0.3,0.4,1.4
E07000212,RUNNYMEDE,38707,38505,96.3,71.6,69.3,4.7,4.7,0.0,0.1,0.8,3.2,0.0,97.7,0.0,37256,27711,26808,1812,1812,2,48,293,1249,17,37803,0,10448,26808,2,46,245,956,27.0,69.3,0.0,0.1,0.6,2.5
E07000176,RUSHCLIFFE,54373,54192,97.2,75.9,72.3,33.9,33.9,0.2,0.4,0.8,2.5,0.2,99.2,3.0,52827,41277,39327,18444,18444,105,242,460,1365,105,53960,1620,13500,39327,105,137,218,905,24.8,72.3,0.2,0.3,0.4,1.7
E07000092,RUSHMOOR,43031,42874,97.1,81.6,81.4,4.6,4.6,0.1,0.9,1.7,2.6,0.1,97.3,0.0,41775,35133,35021,1974,1974,52,384,722,1099,45,41865,0,6754,35021,52,332,338,377,15.7,81.4,0.1,0.8,0.8,0.9
E06000017,RUTLAND,18683,18591,91.1,14.0,14.0,14.0,14.0,0.3,0.5,0.9,8.4,0.3,98.8,0.0,17018,2621,2621,2621,2621,53,91,176,1573,53,18467,9,14397,2621,53,38,85,1397,77.1,14.0,0.3,0.2,0.5,7.5
E07000167,RYEDALE,30343,29620,84.2,9.0,9.0,9.0,9.0,2.8,5.2,7.6,13.4,2.7,93.8,30.0,25549,2717,2717,2717,2717,864,1568,2318,4071,816,28475,9092,22832,2717,864,704,750,1753,75.2,9.0,2.8,2.3,2.5,5.8
E08000006,SALFORD,129201,128804,95.7,83.1,82.7,57.3,82.4,0.0,0.7,2.0,4.0,0.0,95.8,0.0,123589,107412,106844,73975,106459,13,968,2549,5215,17,123837,0,16745,106844,13,955,1581,2666,13.0,82.7,0.0,0.7,1.2,2.1
E08000028,SANDWELL,142350,141958,99.1,83.9,82.3,16.4,72.6,0.0,0.0,0.2,0.6,0.0,99.1,0.0,141042,119367,117191,23280,103376,16,38,344,916,4,141098,6,23851,117191,16,22,306,572,16.8,82.3,0.0,0.0,0.2,0.4
E07000168,SCARBOROUGH,63547,63266,93.7,3.3,3.3,3.3,3.3,0.7,1.2,1.8,5.9,0.7,97.9,5.9,59528,2118,2118,2115,2115,421,781,1157,3738,429,62188,3767,57410,2118,421,360,376,2581,90.3,3.3,0.7,0.6,0.6,4.1
S12000026,SCOTTISH BORDERS,62659,61625,86.0,22.2,19.3,17.1,17.1,1.8,4.2,7.0,12.3,3.2,94.6,15.4,53913,13934,12074,10732,10732,1109,2603,4386,7712,1986,59258,9631,41839,12074,1109,1494,1783,3326,66.8,19.3,1.8,2.4,2.8,5.3
E07000188,SEDGEMOOR,59608,59370,93.6,37.1,26.4,19.8,19.8,0.2,0.9,1.9,6.0,0.5,97.5,0.0,55813,22115,15711,11801,11801,134,522,1111,3557,319,58100,0,40102,15711,134,388,589,2446,67.3,26.4,0.2,0.7,1.0,4.1
E08000014,SEFTON,135482,134864,98.3,72.6,66.8,34.2,62.2,0.0,0.1,0.2,1.3,0.0,99.2,0.2,133144,98298,90561,46305,84244,5,83,248,1720,44,134368,263,42583,90561,5,78,165,1472,31.4,66.8,0.0,0.1,0.1,1.1
E07000169,SELBY,43288,42983,93.0,20.7,20.7,20.7,20.7,0.7,1.2,2.1,6.3,0.7,97.6,14.1,40248,8942,8941,8939,8940,286,534,920,2735,321,42250,6117,31307,8941,286,248,386,1815,72.3,20.7,0.7,0.6,0.9,4.2
E07000111,SEVENOAKS,53495,53273,93.5,52.6,52.4,28.4,47.0,0.2,0.5,1.0,6.1,0.3,99.1,0.0,49998,28127,28036,15171,25149,86,255,531,3275,176,53037,0,21962,28036,86,169,276,2744,41.1,52.4,0.2,0.3,0.5,5.1
E08000019,SHEFFIELD,262024,260972,96.4,53.3,49.8,13.9,13.9,0.0,0.1,0.6,3.2,0.0,97.2,0.1,252484,139649,130553,36413,36414,57,248,1692,8488,103,254685,198,121931,130553,57,191,1444,6796,46.5,49.8,0.0,0.1,0.6,2.6
S12000027,SHETLAND ISLANDS,11652,11241,71.0,1.9,1.9,1.9,1.9,3.0,7.1,16.5,25.5,6.6,83.4,0.0,8273,216,216,216,216,347,831,1918,2968,767,9719,0,8057,216,347,484,1087,1050,69.1,1.9,3.0,4.2,9.3,9.0
E06000051,SHROPSHIRE,153608,152583,86.3,22.7,16.8,10.1,10.1,0.9,2.9,5.6,13.1,0.9,95.4,77.9,132510,34868,25882,15481,15481,1455,4500,8673,20073,1325,146522,119674,106628,25882,1455,3045,4173,11400,69.4,16.8,0.9,2.0,2.7,7.4
E06000039,SLOUGH,57756,57530,98.2,91.2,88.1,43.5,44.4,0.0,0.1,0.3,1.4,0.0,98.4,0.0,56734,52688,50881,25111,25628,10,50,151,796,6,56836,0,5853,50881,10,40,101,645,10.1,88.1,0.0,0.1,0.2,1.1
E08000029,SOLIHULL,97857,96939,96.7,87.9,86.9,34.7,86.3,0.0,0.3,1.1,2.4,0.0,97.2,0.0,94583,85988,85043,33973,84411,46,278,1097,2356,40,95124,3,9540,85043,46,232,819,1259,9.7,86.9,0.0,0.2,0.8,1.3
E07000246,SOMERSET WEST AND TAUNTON,78087,77585,88.4,26.0,16.7,9.6,9.6,0.8,2.5,4.8,10.9,1.5,95.5,5.5,69039,20323,13055,7464,7464,655,1961,3728,8546,1166,74594,4296,55984,13055,655,1306,1767,4818,71.7,16.7,0.8,1.7,2.3,6.2
S12000028,SOUTH AYRSHIRE,58840,58747,94.0,60.0,59.2,15.9,15.9,0.4,1.2,2.6,5.9,1.1,98.4,0.0,55304,35323,34828,9375,9375,216,726,1541,3443,642,57884,0,20476,34828,216,510,815,1902,34.8,59.2,0.4,0.9,1.4,3.2
E07000012,SOUTH CAMBRIDGESHIRE,71523,71139,95.5,57.1,55.0,17.2,17.2,0.2,0.5,1.4,3.9,0.3,98.2,0.8,68315,40820,39352,12330,12333,141,365,977,2824,198,70231,576,28963,39352,141,224,612,1847,40.5,55.0,0.2,0.3,0.9,2.6
E07000039,SOUTH DERBYSHIRE,49242,48720,94.2,41.8,36.8,31.3,31.3,0.2,0.8,1.3,4.7,0.8,98.2,0.0,46403,20594,18112,15421,15421,116,384,623,2317,371,48352,0,28291,18112,116,268,239,1694,57.5,36.8,0.2,0.5,0.5,3.4
E06000025,SOUTH GLOUCESTERSHIRE,126938,126427,98.1,80.2,79.1,13.4,13.4,0.1,0.2,0.5,1.5,0.1,99.1,0.0,124522,101784,100401,17012,17012,97,238,678,1905,81,125811,0,24121,100401,97,141,440,1227,19.0,79.1,0.1,0.1,0.3,1.0
E07000044,SOUTH HAMS,48604,48217,82.2,25.2,24.3,20.7,20.7,0.8,2.8,7.0,17.0,2.4,94.0,32.0,39946,12226,11822,10082,10082,395,1371,3393,8271,1185,45705,15572,28124,11822,395,976,2022,4878,57.9,24.3,0.8,2.0,4.2,10.0
E07000140,SOUTH HOLLAND,44312,43958,89.0,12.7,9.2,7.0,7.0,0.5,1.7,3.1,10.2,1.3,98.3,0.5,39432,5640,4093,3111,3111,210,753,1372,4526,589,43553,231,35339,4093,210,543,619,3154,79.8,9.2,0.5,1.2,1.4,7.1
E07000141,SOUTH KESTEVEN,68729,68476,93.2,33.9,32.3,6.2,6.2,0.9,1.5,2.0,6.4,0.3,98.3,0.0,64070,23315,22167,4254,4254,643,999,1388,4406,235,67542,18,41903,22167,643,356,389,3018,61.0,32.3,0.9,0.5,0.6,4.4
E07000031,SOUTH LAKELAND,60423,60134,93.4,14.2,12.6,11.6,11.6,0.4,1.0,1.8,6.1,0.9,98.2,33.8,56439,8554,7607,7003,7003,241,619,1106,3695,552,59323,20438,48832,7607,241,378,487,2589,80.8,12.6,0.4,0.6,0.8,4.3
S12000029,SOUTH LANARKSHIRE,161060,160616,95.9,71.7,71.2,17.3,70.9,0.4,0.9,1.8,3.8,0.4,98.4,0.0,154475,115475,114642,27883,114174,662,1529,2924,6141,588,158518,0,39833,114642,662,867,1395,3217,24.7,71.2,0.4,0.5,0.9,2.0
E07000149,SOUTH NORFOLK,66130,65869,91.5,17.2,16.5,11.9,11.9,0.4,1.3,2.5,8.1,1.4,98.2,0.0,60490,11387,10911,7894,7894,234,855,1632,5379,933,64936,16,49579,10911,234,621,777,3747,75.0,16.5,0.4,0.9,1.2,5.7
E07000179,SOUTH OXFORDSHIRE,67036,66642,96.1,51.6,46.5,24.1,24.1,0.1,0.3,0.7,3.3,0.3,99.1,0.0,64423,34578,31168,16128,16129,72,226,456,2219,168,66465,0,33255,31168,72,154,230,1763,49.6,46.5,0.1,0.2,0.3,2.6
E07000126,SOUTH RIBBLE,53115,52984,97.0,68.9,67.4,6.7,6.7,0.0,0.4,0.8,2.8,0.0,98.9,34.5,51500,36585,35795,3537,3537,26,214,427,1484,16,52530,18343,15705,35795,26,188,213,1057,29.6,67.4,0.0,0.4,0.4,2.0
E07000189,SOUTH SOMERSET,84437,83593,88.9,9.3,8.9,8.8,8.8,0.6,2.1,3.8,10.1,0.9,96.6,1.6,75099,7830,7556,7462,7462,473,1737,3169,8494,779,81556,1370,67543,7556,473,1264,1432,5325,80.0,8.9,0.6,1.5,1.7,6.3
E07000196,SOUTH STAFFORDSHIRE,50027,49821,92.3,36.1,31.7,28.7,28.8,0.2,0.9,1.9,7.3,0.2,98.2,5.4,46162,18066,15877,14351,14423,99,444,963,3659,92,49143,2711,30285,15877,99,345,519,2696,60.5,31.7,0.2,0.7,1.0,5.4
E08000023,SOUTH TYNESIDE,75667,75625,97.8,77.0,76.4,1.5,1.5,0.1,0.3,0.6,2.1,0.0,98.8,0.0,74021,58241,57816,1115,1115,47,230,422,1604,1,74751,0,16205,57816,47,183,192,1182,21.4,76.4,0.1,0.2,0.3,1.6
E06000045,SOUTHAMPTON,113754,113529,96.8,92.4,91.3,39.3,85.4,0.0,0.0,0.7,3.0,0.0,97.2,0.0,110166,105095,103837,44722,97129,5,33,812,3363,17,110518,0,6329,103837,5,28,779,2551,5.6,91.3,0.0,0.0,0.7,2.2
E06000033,SOUTHEND-ON-SEA,86938,86520,97.4,75.6,69.5,33.1,33.1,0.0,0.0,0.0,2.1,0.0,97.7,0.2,84682,65729,60444,28774,28774,0,2,14,1838,2,84940,162,24238,60444,0,2,12,1824,27.9,69.5,0.0,0.0,0.0,2.1
E09000028,SOUTHWARK,150308,149459,93.4,79.0,78.0,49.5,77.8,0.0,0.0,0.3,6.0,0.0,93.5,0.0,140460,118698,117266,74429,116895,0,61,402,8999,11,140473,0,23194,117266,0,61,341,8597,15.4,78.0,0.0,0.0,0.2,5.7
E07000213,SPELTHORNE,45023,44787,96.9,83.7,82.2,22.9,22.9,0.0,0.0,0.6,2.6,0.0,97.5,0.0,43634,37699,37027,10322,10322,0,15,279,1153,4,43913,0,6607,37027,0,15,264,874,14.7,82.2,0.0,0.0,0.6,1.9
E07000240,ST ALBANS,64841,64626,97.1,85.5,83.6,36.5,36.5,0.0,0.1,0.3,2.6,0.0,98.3,0.0,62950,55425,54193,23652,23652,28,68,180,1676,26,63751,0,8757,54193,28,40,112,1496,13.5,83.6,0.0,0.1,0.2,2.3
E08000013,ST. HELENS,88388,88135,97.2,84.3,81.2,6.3,78.9,0.1,0.4,0.8,2.5,0.1,98.6,11.9,85890,74542,71794,5570,69757,123,379,722,2245,83,87139,10534,14096,71794,123,256,343,1523,15.9,81.2,0.1,0.3,0.4,1.7
E07000197,STAFFORD,65387,65209,94.1,65.4,65.2,16.8,19.6,0.3,0.8,1.7,5.6,0.4,98.3,0.7,61552,42732,42621,10981,12804,183,523,1131,3657,237,64303,453,18931,42621,183,340,608,2526,29.0,65.2,0.3,0.5,0.9,3.9
E07000198,STAFFORDSHIRE MOORLANDS,46729,46522,91.0,28.4,27.4,3.2,3.2,0.7,1.6,3.3,8.6,1.2,97.5,0.0,42512,13252,12795,1481,1481,307,758,1521,4010,544,45574,0,29717,12795,307,451,763,2489,63.6,27.4,0.7,1.0,1.6,5.3
E07000243,STEVENAGE,39636,39486,99.0,87.2,86.9,3.0,3.0,0.0,0.0,0.1,0.7,0.0,99.1,0.0,39226,34559,34444,1172,1172,0,18,37,260,0,39261,0,4782,34444,0,18,19,223,12.1,86.9,0.0,0.0,0.0,0.6
S12000030,STIRLING,46483,45857,88.9,52.5,50.1,49.1,49.2,1.4,3.0,4.7,9.7,2.7,95.8,0.0,41330,24409,23272,22844,22852,636,1380,2203,4527,1257,44549,0,18058,23272,636,744,823,2324,38.8,50.1,1.4,1.6,1.8,5.0
E08000007,STOCKPORT,140332,139197,97.8,83.8,83.6,7.6,31.1,0.0,0.1,0.2,1.4,0.0,98.5,7.9,137292,117543,117327,10611,43671,24,210,295,1905,22,138189,11093,19965,117327,24,186,85,1610,14.2,83.6,0.0,0.1,0.1,1.1
E06000004,STOCKTON-ON-TEES,92788,92543,95.6,87.1,86.2,5.7,5.7,0.1,0.7,1.7,4.1,0.2,96.4,21.8,88725,80817,80029,5296,5296,79,629,1536,3818,153,89447,20209,8696,80029,79,550,907,2282,9.4,86.2,0.1,0.6,1.0,2.5
E06000021,STOKE-ON-TRENT,123439,122977,97.6,81.2,81.1,8.8,8.8,0.0,0.1,0.4,2.0,0.1,98.3,0.0,120484,100240,100170,10835,10835,0,79,455,2493,109,121395,0,20314,100170,0,79,376,2038,16.5,81.1,0.0,0.1,0.3,1.7
E07000221,STRATFORD-ON-AVON,65988,65571,94.0,45.4,40.1,19.3,36.1,0.4,1.0,1.8,5.4,0.6,97.7,1.2,62013,29988,26461,12707,23815,242,669,1200,3558,365,64481,772,35552,26461,242,427,531,2358,53.9,40.1,0.4,0.6,0.8,3.6
E07000082,STROUD,57435,57181,91.1,21.0,20.9,17.4,17.4,0.4,1.1,2.3,8.5,0.3,94.8,1.4,52319,12061,12024,9984,9984,203,615,1313,4862,172,54460,795,40295,12024,203,412,698,3549,70.2,20.9,0.4,0.7,1.2,6.2
E08000024,SUNDERLAND,137257,136581,96.4,65.6,61.2,9.8,9.8,0.1,0.2,0.8,3.1,0.1,97.5,0.0,132270,90028,84043,13468,13468,92,316,1161,4311,113,133881,0,48227,84043,92,224,845,3150,35.1,61.2,0.1,0.2,0.6,2.3
E07000214,SURREY HEATH,38902,38791,98.0,67.5,66.7,9.1,9.1,0.0,0.0,0.1,1.7,0.0,99.6,0.0,38122,26276,25948,3523,3523,1,17,48,669,6,38741,0,12174,25948,1,16,31,621,31.3,66.7,0.0,0.0,0.1,1.6
E09000029,SUTTON,87458,87233,98.2,86.5,84.6,8.3,83.7,0.0,0.0,0.1,1.5,0.0,98.4,0.0,85887,75685,73987,7248,73233,11,18,107,1346,1,86073,0,11900,73987,11,7,89,1239,13.6,84.6,0.0,0.0,0.1,1.4
E07000113,SWALE,67743,67188,93.5,50.4,44.0,16.2,16.2,0.2,0.7,1.6,5.7,0.3,98.2,29.5,63311,34146,29792,10971,10971,140,500,1101,3877,184,66531,19963,33519,29792,140,360,601,2776,49.5,44.0,0.2,0.5,0.9,4.1
W06000011,SWANSEA,118819,118332,97.5,80.2,77.5,30.6,30.6,0.1,0.2,0.6,2.1,0.2,98.3,49.3,115811,95339,92121,36380,36388,126,285,703,2521,233,116852,58592,23690,92121,126,159,418,1818,19.9,77.5,0.1,0.1,0.4,1.5
E06000030,SWINDON,102416,102320,91.8,83.5,80.8,20.3,20.3,0.0,1.1,2.4,8.2,0.8,92.2,0.0,93967,85470,82768,20773,20773,40,1164,2482,8353,869,94419,0,11199,82768,40,1124,1318,5871,10.9,80.8,0.0,1.1,1.3,5.7
E08000008,TAMESIDE,116096,115458,97.0,57.0,56.2,17.7,17.7,0.0,0.0,0.1,2.5,0.0,99.0,0.0,112585,66224,65188,20539,20550,4,35,165,2873,7,114929,0,47397,65188,4,31,130,2708,40.8,56.2,0.0,0.0,0.1,2.3
E07000199,TAMWORTH,35592,35508,99.0,85.3,82.1,4.3,79.7,0.1,0.1,0.2,0.7,0.0,99.5,0.0,35253,30376,29225,1539,28379,34,41,75,255,4,35399,0,6028,29225,34,7,34,180,16.9,82.1,0.1,0.0,0.1,0.5
E07000215,TANDRIDGE,38690,38496,93.6,54.5,49.5,12.7,12.8,0.1,0.6,1.1,5.9,0.2,99.0,0.0,36204,21073,19153,4923,4941,50,243,436,2292,80,38298,0,17051,19153,50,193,193,1856,44.1,49.5,0.1,0.5,0.5,4.8
E07000045,TEIGNBRIDGE,66523,66186,88.6,37.1,36.9,11.4,11.4,0.4,1.7,3.6,10.9,0.9,96.5,28.9,58958,24652,24515,7601,7601,292,1132,2389,7228,590,64162,19253,34443,24515,292,840,1257,4839,51.8,36.9,0.4,1.3,1.9,7.3
E06000020,TELFORD AND WREKIN,82037,81760,97.6,80.9,78.3,8.3,8.3,0.1,0.2,0.4,2.0,0.0,99.0,38.4,80106,66379,64203,6846,6846,60,147,345,1654,40,81183,31541,15903,64203,60,87,198,1309,19.4,78.3,0.1,0.1,0.2,1.6
E07000076,TENDRING,74635,74245,97.7,10.9,10.9,10.9,10.9,0.1,0.3,0.6,1.8,0.1,99.0,2.9,72886,8151,8151,8144,8144,106,221,441,1359,65,73903,2178,64735,8151,106,115,220,918,86.7,10.9,0.1,0.2,0.3,1.2
E07000093,TEST VALLEY,59488,59312,93.7,66.6,65.6,17.5,19.7,0.2,0.8,2.0,6.0,0.7,98.5,0.0,55766,39598,39049,10421,11721,115,485,1201,3546,408,58587,0,16717,39049,115,370,716,2345,28.1,65.6,0.2,0.6,1.2,3.9
E07000083,TEWKESBURY,46865,46053,90.4,58.4,56.1,26.8,26.8,0.2,1.2,2.4,7.9,0.7,92.2,0.7,42364,27379,26309,12538,12538,110,560,1137,3689,339,43210,310,16055,26309,110,450,577,2552,34.3,56.1,0.2,1.0,1.2,5.4
E07000114,THANET,73328,72782,96.7,57.2,56.9,57.1,57.1,0.0,0.6,1.3,2.6,0.0,98.9,24.5,70897,41952,41718,41855,41855,13,460,957,1885,7,72517,17971,29179,41718,13,447,497,928,39.8,56.9,0.0,0.6,0.7,1.3
E07000102,THREE RIVERS,39742,39606,97.0,79.2,76.5,19.2,19.3,0.2,0.3,0.5,2.7,0.0,99.3,0.0,38541,31460,30386,7642,7659,72,100,195,1065,14,39480,0,8155,30386,72,28,95,870,20.5,76.5,0.2,0.1,0.2,2.2
E06000034,THURROCK,72372,72153,95.0,75.3,73.9,13.1,13.1,0.1,0.6,2.1,4.7,0.2,96.5,0.0,68752,54474,53507,9451,9451,60,436,1487,3401,141,69822,5,15245,53507,60,376,1051,1914,21.1,73.9,0.1,0.5,1.5,2.6
E07000115,TONBRIDGE AND MALLING,57382,57187,94.8,66.5,64.0,18.2,18.2,0.1,0.4,1.1,4.9,0.3,98.4,8.2,54377,38171,36735,10420,10420,70,238,646,2810,161,56458,4723,17642,36735,70,168,408,2164,30.7,64.0,0.1,0.3,0.7,3.8
E06000027,TORBAY,78247,77566,94.2,76.7,73.9,40.4,40.4,0.0,0.0,0.5,4.9,0.0,96.4,0.2,73710,60037,57851,31619,31619,12,30,393,3856,35,75438,129,15859,57851,12,18,363,3463,20.3,73.9,0.0,0.0,0.5,4.4
W06000020,TORFAEN,45912,45713,96.0,50.2,41.1,12.1,12.1,0.2,0.5,1.3,3.5,0.3,97.3,65.2,44091,23058,18870,5549,5549,72,225,596,1622,120,44650,29943,25221,18870,72,153,371,1026,54.9,41.1,0.2,0.3,0.8,2.2
E07000046,TORRIDGE,34498,34135,81.0,4.0,4.0,4.0,4.0,2.5,6.6,10.7,18.0,2.0,92.5,46.4,27929,1386,1385,1385,1385,848,2280,3690,6206,694,31909,15999,26544,1385,848,1432,1410,2516,76.9,4.0,2.5,4.2,4.1,7.3
E09000030,TOWER HAMLETS,146793,145927,93.1,74.3,71.3,55.9,69.4,0.0,0.0,0.6,6.3,0.0,93.1,0.0,136608,109068,104716,82084,101931,0,56,878,9319,0,136640,0,31892,104716,0,56,822,8441,21.7,71.3,0.0,0.0,0.6,5.8
E08000009,TRAFFORD,107847,107511,97.9,71.3,66.8,2.9,63.4,0.1,0.2,0.3,1.8,0.0,98.9,0.2,105556,76930,72011,3160,68385,61,250,373,1955,10,106641,266,33545,72011,61,189,123,1582,31.1,66.8,0.1,0.2,0.1,1.5
E07000116,TUNBRIDGE WELLS,52926,52623,92.8,61.8,58.5,28.1,28.1,0.1,1.0,2.1,6.6,0.9,98.1,0.1,49114,32731,30984,14873,14873,52,518,1116,3509,461,51923,78,18130,30984,52,466,598,2393,34.3,58.5,0.1,0.9,1.1,4.5
E07000077,UTTLESFORD,41271,40904,92.1,52.1,46.6,33.7,33.7,0.4,1.1,3.2,7.0,1.0,95.8,1.8,38027,21519,19252,13898,13898,164,457,1308,2877,423,39536,732,18775,19252,164,293,851,1569,45.5,46.6,0.4,0.7,2.1,3.8
W06000014,VALE OF GLAMORGAN,62964,62570,96.6,65.3,61.3,41.0,58.5,0.2,1.0,1.4,2.8,0.4,97.9,10.6,60793,41119,38578,25792,36838,154,619,875,1777,270,61647,6693,22215,38578,154,465,256,902,35.3,61.3,0.2,0.7,0.4,1.4
E07000180,VALE OF WHITE HORSE,62655,62404,96.2,62.7,60.3,17.1,17.1,0.1,0.3,0.7,3.4,0.1,98.7,0.0,60260,39267,37780,10723,10724,75,192,447,2144,83,61846,1,22480,37780,75,117,255,1697,35.9,60.3,0.1,0.2,0.4,2.7
E08000036,WAKEFIELD,159988,159339,96.0,56.3,55.7,22.5,22.5,0.0,0.4,0.7,3.6,0.1,98.0,0.4,153637,90012,89086,36048,36049,78,572,1089,5702,172,156758,590,64551,89086,78,494,517,4613,40.3,55.7,0.0,0.3,0.3,2.9
E08000030,WALSALL,118025,117662,98.2,78.8,76.9,11.2,74.8,0.0,0.0,0.5,1.5,0.0,98.7,0.0,115887,93021,90726,13215,88284,4,25,571,1775,39,116469,13,25161,90726,4,21,546,1204,21.3,76.9,0.0,0.0,0.5,1.0
E09000031,WALTHAM FOREST,110258,109710,95.9,87.7,86.1,18.1,85.3,0.0,0.1,0.6,3.6,0.0,96.0,0.0,105777,96654,94930,19943,93996,33,73,655,3933,53,105844,0,10847,94930,33,40,582,3278,9.8,86.1,0.0,0.0,0.5,3.0
E09000032,WANDSWORTH,157397,156235,97.0,86.8,80.6,41.6,74.9,0.0,0.0,0.2,2.3,0.0,97.0,0.0,152651,136617,126833,65478,117943,0,4,331,3584,6,152681,2,25818,126833,0,4,327,3253,16.4,80.6,0.0,0.0,0.2,2.1
E06000007,WARRINGTON,100304,99242,96.7,74.2,70.9,6.6,68.9,0.0,0.1,0.2,2.2,0.0,98.3,0.0,97023,74381,71074,6670,69123,42,118,213,2219,37,98592,8,25949,71074,42,76,95,2006,25.9,70.9,0.0,0.1,0.1,2.0
E07000222,WARWICK,69690,69480,97.3,77.2,71.5,9.7,67.5,0.2,0.8,1.1,2.4,0.1,98.6,0.0,67795,53806,49803,6749,47030,131,561,776,1685,90,68723,1,17992,49803,131,430,215,909,25.8,71.5,0.2,0.6,0.3,1.3
E07000103,WATFORD,42475,42169,98.7,90.1,85.9,3.0,3.0,0.0,0.0,0.1,0.6,0.0,98.8,0.0,41935,38291,36492,1292,1294,0,17,63,234,0,41962,0,5443,36492,0,17,46,171,12.8,85.9,0.0,0.0,0.1,0.4
E07000216,WAVERLEY,56879,56676,94.1,21.4,17.9,7.3,7.3,0.2,0.6,0.9,5.5,0.4,99.2,0.0,53527,12152,10179,4176,4176,128,320,519,3149,236,56448,0,43348,10179,128,192,199,2630,76.2,17.9,0.2,0.3,0.3,4.6
E07000065,WEALDEN,74321,74053,94.9,37.8,37.6,37.6,37.6,0.2,0.6,1.3,4.8,0.6,99.1,0.0,70516,28091,27964,27925,27925,130,481,953,3537,453,73617,0,42552,27964,130,351,472,2584,57.3,37.6,0.2,0.5,0.6,3.5
E07000241,WELWYN HATFIELD,50606,50507,97.2,77.2,75.2,11.4,11.4,0.0,0.1,0.3,2.6,0.0,99.2,0.0,49172,39057,38032,5792,5792,8,38,162,1335,4,50181,0,11140,38032,8,30,124,1173,22.0,75.2,0.0,0.1,0.2,2.3
E06000037,WEST BERKSHIRE,72129,71843,96.9,72.9,68.0,26.3,64.4,0.0,0.4,0.7,2.7,0.2,97.8,0.0,69898,52561,49044,18957,46454,24,284,498,1945,128,70563,0,20854,49044,24,260,214,1447,28.9,68.0,0.0,0.4,0.3,2.0
E07000047,WEST DEVON,27088,26943,79.0,32.5,32.5,32.5,32.5,1.8,5.9,11.7,20.4,1.8,95.0,68.0,21413,8804,8804,8804,8804,476,1602,3157,5530,493,25732,18418,12609,8804,476,1126,1555,2373,46.5,32.5,1.8,4.2,5.7,8.8
S12000039,WEST DUNBARTONSHIRE,47093,47063,98.4,89.7,88.4,1.2,87.2,0.0,0.2,0.5,1.6,0.0,99.1,0.0,46318,42232,41627,547,41086,22,90,228,745,12,46650,0,4691,41627,22,68,138,517,10.0,88.4,0.0,0.1,0.3,1.1
E07000127,WEST LANCASHIRE,52152,51969,95.0,52.1,43.1,37.0,37.1,0.2,0.8,1.3,4.7,0.1,98.7,20.4,49531,27167,22480,19295,19324,121,392,670,2438,45,51482,10621,27051,22480,121,271,278,1768,51.9,43.1,0.2,0.5,0.5,3.4
E07000142,WEST LINDSEY,46403,46027,85.9,34.3,32.1,20.3,20.3,2.1,4.4,6.7,13.3,1.6,96.7,26.0,39839,15913,14895,9420,9420,953,2020,3097,6188,747,44866,12051,24944,14895,953,1067,1077,3091,53.8,32.1,2.1,2.3,2.3,6.7
S12000040,WEST LOTHIAN,86503,86316,97.2,79.0,77.7,41.7,76.9,0.2,0.4,0.9,2.6,0.2,98.8,0.0,84053,68340,67177,36104,66481,139,317,800,2263,156,85496,3,16876,67177,139,178,483,1463,19.5,77.7,0.2,0.2,0.6,1.7
E06000062,WEST NORTHAMPTONSHIRE,187556,185426,96.0,67.5,63.9,30.7,30.7,0.1,0.7,1.3,2.9,0.2,97.1,0.9,180059,126679,119778,57525,57526,233,1276,2447,5367,388,182084,1609,60281,119778,233,1043,1171,2920,32.1,63.9,0.1,0.6,0.6,1.6
E07000181,WEST OXFORDSHIRE,53019,52771,98.7,71.7,65.5,34.6,34.6,0.0,0.1,0.1,0.9,0.2,99.2,0.0,52316,38025,34746,18356,18356,12,29,68,455,96,52597,11,17570,34746,12,17,39,387,33.1,65.5,0.0,0.0,0.1,0.7
E07000245,WEST SUFFOLK,84701,84480,95.6,33.0,26.8,13.8,13.8,0.2,0.4,0.7,4.1,0.3,99.1,0.4,80996,27977,22705,11657,11657,137,334,566,3484,279,83911,359,58291,22705,137,197,232,2918,68.8,26.8,0.2,0.2,0.3,3.4
E09000033,WESTMINSTER,164368,162774,89.3,67.6,66.7,62.5,65.2,0.0,0.0,0.1,9.7,0.0,89.3,0.0,146802,111159,109588,102766,107199,0,0,87,15972,0,146832,0,37214,109588,0,0,87,15885,22.6,66.7,0.0,0.0,0.1,9.7
E08000010,WIGAN,154041,153938,98.5,87.2,86.0,5.7,13.0,0.0,0.1,0.2,1.4,0.0,99.5,5.4,151726,134257,132491,8763,20067,31,138,348,2212,50,153316,8277,19235,132491,31,107,210,1864,12.5,86.0,0.0,0.1,0.1,1.2
E06000054,WILTSHIRE,234351,233481,95.0,47.5,46.0,24.2,24.2,0.2,0.6,1.3,4.6,0.4,98.7,1.7,222636,111385,107838,56795,56795,459,1517,3062,10845,943,231192,3909,114798,107838,459,1058,1545,7783,49.0,46.0,0.2,0.5,0.7,3.3
E07000094,WINCHESTER,56710,56442,90.9,46.1,44.1,8.5,8.6,0.4,1.4,2.7,8.6,0.7,96.8,0.0,51576,26134,25030,4839,4860,255,814,1514,4866,397,54899,0,26546,25030,255,559,700,3352,46.8,44.1,0.4,1.0,1.2,5.9
E06000040,WINDSOR AND MAIDENHEAD,67726,67513,94.3,64.1,60.0,7.9,7.9,0.1,0.2,0.8,5.4,0.1,97.1,0.0,63886,43428,40607,5347,5348,36,148,527,3627,74,65760,0,23279,40607,36,112,379,3100,34.4,60.0,0.1,0.2,0.6,4.6
E08000015,WIRRAL,158449,158158,98.0,73.7,73.5,49.6,49.6,0.0,0.1,0.1,1.8,0.0,99.5,0.0,155346,116747,116447,78591,78593,48,109,233,2812,22,157594,0,38899,116447,48,61,124,2579,24.5,73.5,0.0,0.0,0.1,1.6
E07000217,WOKING,45572,45184,97.7,84.5,80.8,3.7,3.7,0.0,0.3,0.3,1.5,0.1,98.7,0.0,44522,38486,36818,1707,1707,1,141,155,662,24,44970,0,7704,36818,1,140,14,507,16.9,80.8,0.0,0.3,0.0,1.1
E06000041,WOKINGHAM,76327,75000,94.3,71.4,68.2,13.4,66.3,0.0,0.2,0.5,4.0,0.0,96.0,0.0,71950,54525,52060,10257,50627,16,138,401,3050,37,73309,0,19890,52060,16,122,263,2649,26.1,68.2,0.0,0.2,0.3,3.5
E08000031,WOLVERHAMPTON,117866,117580,98.4,91.5,89.7,8.0,8.1,0.0,0.0,0.1,1.3,0.0,98.7,5.0,116028,107868,105760,9373,9601,0,2,95,1552,13,116373,5947,10268,105760,0,2,93,1457,8.7,89.7,0.0,0.0,0.1,1.2
E07000237,WORCESTER,48897,48614,98.5,21.6,10.4,2.6,2.6,0.0,0.0,0.1,0.9,0.0,99.0,0.1,48176,10584,5090,1284,1284,0,0,26,438,9,48425,50,43086,5090,0,0,26,412,88.1,10.4,0.0,0.0,0.1,0.8
E07000229,WORTHING,51717,51657,99.3,94.0,93.6,64.5,64.5,0.0,0.0,0.0,0.6,0.0,99.7,0.0,51358,48631,48419,33374,33374,0,2,8,299,1,51583,0,2939,48419,0,2,6,291,5.7,93.6,0.0,0.0,0.0,0.6
W06000006,WREXHAM,65979,65166,94.7,41.0,40.3,39.9,39.9,0.3,0.9,1.7,4.0,1.0,96.9,43.8,62497,27025,26594,26346,26346,166,569,1125,2669,632,63963,28926,35903,26594,166,403,556,1544,54.4,40.3,0.3,0.6,0.8,2.3
E07000238,WYCHAVON,63045,62429,94.1,22.3,18.4,11.1,11.3,0.2,0.8,1.3,4.9,0.3,98.4,0.4,59326,14053,11582,7018,7125,107,486,797,3103,220,62014,234,47744,11582,107,379,311,2306,75.7,18.4,0.2,0.6,0.5,3.7
E07000128,WYRE,57123,56868,95.2,35.7,35.7,35.4,35.4,0.1,0.3,0.6,4.3,0.0,98.5,10.6,54397,20386,20381,20201,20201,46,154,363,2471,23,56264,6059,34016,20381,46,108,209,2108,59.5,35.7,0.1,0.2,0.4,3.7
E07000239,WYRE FOREST,48324,48103,96.8,48.2,47.8,2.2,47.8,0.2,0.4,0.8,2.8,0.3,99.2,3.5,46769,23287,23097,1060,23096,94,188,384,1334,140,47956,1675,23672,23097,94,94,196,950,49.0,47.8,0.2,0.2,0.4,2.0
E06000014,YORK,96099,95560,94.1,76.8,73.6,58.3,58.3,0.0,0.2,0.7,5.3,0.0,95.9,3.0,90465,73765,70693,56018,56018,40,181,682,5095,37,92146,2918,19772,70693,40,141,501,4413,20.6,73.6,0.0,0.1,0.5,4.6
