parl_const,parliamentary_constituency_name,All Premises,All Matched Premises,SFBB availability (% premises),UFBB (100Mbit/s) availability (% premises),UFBB availability (% premises),Full Fibre availability (% premises),Gigabit availability (% premises),% of premises unable to receive 2Mbit/s,% of premises unable to receive 5Mbit/s,% of premises unable to receive 10Mbit/s,% of premises unable to receive 30Mbit/s,% of premises below the USO,% of premises with NGA,Number of premises with SFBB availability,Number of premises with UFBB (100Mbit/s) availability,Number of premises with UFBB availability,Number of premises unable to receive 2Mbit/s,Number of premises unable to receive 5Mbit/s,Number of premises unable to receive 10Mbit/s,Number of premises unable to receive 30Mbit/s,Number of premises with Full Fibre availability,Number of premises with Gigabit availability,Number of premises below the USO,Number of premises with NGA,Number of premises able to receive decent broadband from FWA,% of premises with 30<300Mbit/s download speed,% of premises with >=300Mbit/s download speed,% of premises able to receive decent broadband from FWA,% of premises with 0<2Mbit/s download speed,% of premises with 2<5Mbit/s download speed,% of premises with 5<10Mbit/s download speed,% of premises with 10<30Mbit/s download speed,Number of premises with 30<300Mbit/s download speed,Number of premises with >=300Mbit/s download speed,Number of premises with 0<2Mbit/s download speed,Number of premises with 2<5Mbit/s download speed,Number of premises with 5<10Mbit/s download speed,Number of premises with 10<30Mbit/s download speed
E14000530,ALDERSHOT,45101,45048,97.9,83.7,83.6,4.8,4.8,0.1,0.7,1.1,2.0,0.1,98.2,44150,37764,37722,45,308,514,898,2180,2180,44,44269,0,14.3,83.6,0.0,0.1,0.6,0.5,0.9,6428,37722,45,263,206,384
E14000531,ALDRIDGE-BROWNHILLS,32642,32607,98.2,85.0,81.9,16.9,80.8,0.0,0.0,0.4,1.7,0.0,98.8,32068,27744,26720,2,2,127,539,5501,26386,5,32235,0,16.4,81.9,0.0,0.0,0.0,0.4,1.3,5348,26720,2,0,125,412
E14000532,ALTRINCHAM AND SALE WEST,42486,42413,97.2,71.2,63.0,2.4,57.0,0.1,0.4,0.5,2.6,0.0,99.1,41305,30248,26752,49,166,220,1108,1037,24199,1,42086,247,34.3,63.0,0.6,0.1,0.3,0.1,2.1,14553,26752,49,117,54,888
E14000533,AMBER VALLEY,41196,41045,96.2,28.6,28.0,27.9,27.9,0.0,0.1,0.4,3.5,0.1,99.1,39622,11767,11537,11,55,183,1423,11503,11503,40,40833,0,68.2,28.0,0.0,0.0,0.1,0.3,3.0,28085,11537,11,44,128,1240
E14000534,ARUNDEL AND SOUTH DOWNS,45618,45435,91.9,11.7,10.4,9.6,9.6,0.4,1.1,2.2,7.7,0.9,98.8,41943,5356,4766,184,517,988,3492,4400,4400,433,45071,0,81.5,10.4,0.0,0.4,0.7,1.0,5.5,37177,4766,184,333,471,2504
E14000535,ASHFIELD,47106,46966,98.3,89.3,89.3,4.1,4.1,0.0,0.3,0.4,1.4,0.2,98.9,46291,42072,42047,3,158,187,675,1914,1914,84,46581,0,9.0,89.3,0.0,0.0,0.3,0.1,1.0,4244,42047,3,155,29,488
E14000536,ASHFORD,52508,52407,92.8,53.3,50.2,9.8,9.8,0.2,1.3,2.6,7.0,0.6,98.9,48719,27990,26367,126,700,1340,3688,5155,5155,331,51930,17553,42.6,50.2,33.4,0.2,1.1,1.2,4.5,22352,26367,126,574,640,2348
E14000537,ASHTON-UNDER-LYNE,42882,42763,98.9,85.9,85.4,43.2,43.4,0.0,0.0,0.0,0.8,0.0,99.4,42427,36836,36608,0,3,13,336,18506,18597,0,42620,0,13.6,85.4,0.0,0.0,0.0,0.0,0.8,5819,36608,0,3,10,323
E14000538,AYLESBURY,51169,51019,97.4,70.8,65.2,10.9,10.9,0.0,0.2,0.4,2.3,0.1,99.0,49844,36234,33348,10,91,181,1175,5586,5586,51,50667,0,32.2,65.2,0.0,0.0,0.2,0.2,1.9,16496,33348,10,81,90,994
E14000539,BANBURY,56400,56232,96.8,42.1,31.8,10.9,10.9,0.3,0.4,1.0,2.9,0.2,98.6,54579,23771,17910,152,242,566,1653,6142,6142,98,55616,291,65.0,31.8,0.5,0.3,0.2,0.6,1.9,36669,17910,152,90,324,1087
E14000540,BARKING,50698,50667,99.3,90.0,90.0,50.4,90.0,0.0,0.1,0.1,0.6,0.0,99.4,50360,45653,45650,0,60,72,307,25538,45650,0,50373,0,9.3,90.0,0.0,0.0,0.1,0.0,0.5,4710,45650,0,60,12,235
E14000541,BARNSLEY CENTRAL,42191,42098,99.3,88.6,87.4,15.7,15.7,0.0,0.0,0.0,0.5,0.0,99.7,41896,37381,36882,0,4,20,202,6635,6636,0,42070,0,11.9,87.4,0.0,0.0,0.0,0.0,0.4,5014,36882,0,4,16,182
E14000542,BARNSLEY EAST,42748,42687,98.9,83.5,79.9,41.9,41.9,0.0,0.1,0.1,0.9,0.0,99.5,42286,35679,34168,2,23,57,401,17905,17905,1,42549,0,19.0,79.9,0.0,0.0,0.0,0.1,0.8,8118,34168,2,21,34,344
E14000543,BARROW AND FURNESS,43520,43418,97.4,1.2,1.2,1.2,1.2,0.2,0.4,0.7,2.3,0.4,99.6,42399,530,530,79,187,304,1019,530,530,168,43354,1154,96.2,1.2,2.7,0.2,0.2,0.3,1.6,41869,530,79,108,117,715
E14000544,BASILDON AND BILLERICAY,40715,40665,98.1,80.5,79.6,30.4,30.4,0.0,0.1,0.3,1.8,0.0,99.6,39925,32783,32406,6,58,119,740,12388,12388,4,40564,0,18.5,79.6,0.0,0.0,0.1,0.1,1.5,7519,32406,6,52,61,621
E14000545,BASINGSTOKE,49992,49942,98.5,75.7,75.4,27.7,75.6,0.0,0.1,0.3,1.4,0.1,99.1,49267,37828,37669,0,72,146,675,13850,37797,64,49525,0,23.2,75.4,0.0,0.0,0.1,0.1,1.1,11598,37669,0,72,74,529
E14000546,BASSETLAW,49479,49232,96.6,38.2,36.3,9.7,9.7,0.3,0.5,0.7,2.9,0.3,99.2,47779,18881,17966,154,264,370,1453,4809,4810,133,49071,3534,60.3,36.3,7.1,0.3,0.2,0.2,2.2,29813,17966,154,110,106,1083
E14000547,BATH,42082,42013,96.7,69.4,60.8,25.5,25.5,0.0,0.0,0.1,3.2,0.0,97.4,40684,29210,25604,0,10,43,1329,10728,10728,2,40993,0,35.8,60.8,0.0,0.0,0.0,0.1,3.1,15080,25604,0,10,33,1286
E14000548,BATLEY AND SPEN,46524,46455,97.2,78.9,78.4,50.7,51.9,0.0,0.0,0.1,2.7,0.0,99.0,45221,36709,36471,1,10,46,1234,23581,24139,3,46071,0,18.8,78.4,0.0,0.0,0.0,0.1,2.6,8750,36471,1,9,36,1188
E14000549,BATTERSEA,58821,58263,97.6,93.2,89.2,40.3,85.5,0.0,0.0,0.0,1.4,0.0,97.6,57422,54809,52441,0,0,26,841,23691,50307,4,57422,0,8.5,89.2,0.0,0.0,0.0,0.0,1.4,4981,52441,0,0,26,815
E14000550,BEACONSFIELD,44297,44208,94.2,50.5,46.0,24.3,34.4,0.0,0.3,1.4,5.6,0.2,98.1,41728,22387,20367,16,133,602,2480,10756,15226,99,43473,0,48.2,46.0,0.0,0.0,0.3,1.1,4.2,21361,20367,16,117,469,1878
E14000551,BECKENHAM,39453,39434,98.9,86.4,85.7,1.4,85.1,0.0,0.0,0.1,1.0,0.0,99.5,39029,34072,33824,2,4,21,405,567,33581,0,39267,0,13.2,85.7,0.0,0.0,0.0,0.0,1.0,5205,33824,2,2,17,384
E14000552,BEDFORD,47023,46951,99.1,92.5,89.7,4.1,4.1,0.0,0.0,0.1,0.7,0.0,99.2,46604,43473,42189,3,10,31,347,1942,1942,0,46659,0,9.4,89.7,0.0,0.0,0.0,0.0,0.7,4415,42189,3,7,21,316
E14000553,BERMONDSEY AND OLD SOUTHWARK,68948,68777,92.9,77.7,77.4,66.2,77.4,0.0,0.0,0.3,6.8,0.0,92.9,64077,53577,53351,0,5,204,4700,45642,53351,8,64082,0,15.6,77.4,0.0,0.0,0.0,0.3,6.5,10726,53351,0,5,199,4496
E14000554,BERWICK-UPON-TWEED,34951,34829,90.5,8.8,8.8,8.8,8.8,1.2,2.7,4.2,9.2,1.8,96.9,31619,3082,3081,421,950,1461,3210,3081,3081,612,33877,2848,81.7,8.8,8.1,1.2,1.5,1.5,5.0,28538,3081,421,529,511,1749
E14000555,BETHNAL GREEN AND BOW,59967,59676,93.0,72.9,67.3,45.6,64.0,0.0,0.0,0.2,6.5,0.0,93.0,55776,43691,40364,0,0,143,3900,27323,38358,0,55785,0,25.7,67.3,0.0,0.0,0.0,0.2,6.3,15412,40364,0,0,143,3757
E14000556,BEVERLEY AND HOLDERNESS,46324,46180,96.6,72.2,72.2,72.2,72.2,0.4,0.8,1.3,3.1,0.2,98.5,44759,33442,33442,180,374,597,1421,33442,33442,88,45638,13316,24.4,72.2,28.7,0.4,0.4,0.5,1.8,11317,33442,180,194,223,824
E14000557,BEXHILL AND BATTLE,49041,48816,95.1,9.1,9.1,9.1,9.1,0.1,0.2,0.9,4.4,0.3,99.2,46646,4476,4476,27,119,437,2170,4476,4476,128,48658,0,86.0,9.1,0.0,0.1,0.2,0.6,3.5,42170,4476,27,92,318,1733
E14000558,BEXLEYHEATH AND CRAYFORD,37285,37236,98.3,92.1,91.7,59.7,91.6,0.0,0.0,0.4,1.6,0.0,98.4,36636,34333,34177,0,2,139,600,22274,34167,0,36686,0,6.6,91.7,0.0,0.0,0.0,0.4,1.2,2459,34177,0,2,137,461
E14000559,BIRKENHEAD,43728,43703,99.6,92.2,92.2,63.4,63.4,0.0,0.0,0.0,0.4,0.0,99.8,43545,40308,40308,0,0,3,158,27741,27741,0,43657,0,7.4,92.2,0.0,0.0,0.0,0.0,0.4,3237,40308,0,0,3,155
E14000560,"BIRMINGHAM, EDGBASTON",43354,42481,95.6,89.2,89.0,40.3,88.9,0.0,0.1,0.5,2.4,0.0,95.7,41429,38687,38576,15,65,232,1052,17461,38543,0,41476,1,6.6,89.0,0.0,0.0,0.1,0.4,1.9,2853,38576,15,50,167,820
E14000561,"BIRMINGHAM, ERDINGTON",43370,43338,97.0,92.2,90.2,14.2,88.7,0.0,0.3,1.4,3.0,0.0,97.0,42058,40006,39116,1,142,618,1280,6157,38472,0,42062,0,6.8,90.2,0.0,0.0,0.3,1.1,1.5,2942,39116,1,141,476,662
E14000562,"BIRMINGHAM, HALL GREEN",40567,40555,98.8,93.9,93.7,39.5,93.5,0.0,0.0,0.1,1.2,0.0,99.0,40060,38111,38028,0,1,24,495,16024,37923,0,40143,0,5.0,93.7,0.0,0.0,0.0,0.1,1.2,2032,38028,0,1,23,471
E14000563,"BIRMINGHAM, HODGE HILL",40598,40566,99.7,97.8,97.5,19.8,97.1,0.0,0.0,0.1,0.2,0.0,99.7,40489,39703,39578,0,13,59,77,8034,39438,0,40496,1,2.2,97.5,0.0,0.0,0.0,0.1,0.0,911,39578,0,13,46,18
E14000564,"BIRMINGHAM, LADYWOOD",56901,56291,91.6,82.4,80.2,38.1,78.2,0.0,0.0,0.2,7.3,0.0,91.6,52146,46881,45644,0,1,98,4145,21685,44492,0,52146,244,11.4,80.2,0.4,0.0,0.0,0.2,7.1,6502,45644,0,1,97,4047
E14000565,"BIRMINGHAM, NORTHFIELD",46359,46337,97.7,93.2,93.2,14.5,93.2,0.0,0.0,1.2,2.3,0.0,97.8,45270,43227,43212,0,21,548,1067,6713,43212,0,45326,45,4.4,93.2,0.1,0.0,0.0,1.1,1.1,2058,43212,0,21,527,519
E14000566,"BIRMINGHAM, PERRY BARR",40851,40731,98.1,97.1,96.6,72.1,96.2,0.0,0.1,0.1,1.6,0.0,98.1,40060,39661,39445,5,23,45,671,29449,39299,0,40060,0,1.5,96.6,0.0,0.0,0.0,0.1,1.5,615,39445,5,18,22,626
E14000567,"BIRMINGHAM, SELLY OAK",43477,42982,97.2,94.2,94.1,40.4,94.2,0.0,0.0,0.4,1.7,0.0,97.3,42263,40951,40904,0,21,154,719,17550,40949,0,42308,0,3.1,94.1,0.0,0.0,0.0,0.3,1.3,1359,40904,0,21,133,565
E14000568,"BIRMINGHAM, YARDLEY",43296,43271,99.5,98.3,98.0,78.4,97.9,0.0,0.0,0.3,0.5,0.0,99.5,43060,42549,42441,3,7,119,211,33925,42374,0,43060,0,1.4,98.0,0.0,0.0,0.0,0.3,0.2,619,42441,3,4,112,92
E14000569,BISHOP AUCKLAND,43675,43576,92.2,31.3,31.2,31.3,31.3,0.9,2.0,3.4,7.5,1.1,97.9,40283,13654,13630,393,874,1473,3293,13654,13654,465,42770,950,61.0,31.2,2.2,0.9,1.1,1.4,4.2,26653,13630,393,481,599,1820
E14000570,BLACKBURN,42942,42890,99.2,77.4,77.4,6.7,6.7,0.0,0.0,0.1,0.7,0.0,99.5,42592,33248,33245,0,11,34,298,2874,2877,6,42724,29539,21.8,77.4,68.8,0.0,0.0,0.1,0.6,9347,33245,0,11,23,264
E14000571,BLACKLEY AND BROUGHTON,49710,49638,96.7,68.8,63.5,17.9,61.2,0.0,0.1,1.5,3.1,0.0,97.4,48088,34219,31590,1,32,765,1550,8905,30444,3,48401,0,33.2,63.5,0.0,0.0,0.1,1.5,1.6,16498,31590,1,31,733,785
E14000572,BLACKPOOL NORTH AND CLEVELEYS,42021,41990,99.0,55.3,55.3,2.7,2.7,0.0,0.0,0.1,0.9,0.0,99.5,41602,23250,23222,0,7,23,388,1114,1114,0,41805,459,43.7,55.3,1.1,0.0,0.0,0.0,0.9,18380,23222,0,7,16,365
E14000573,BLACKPOOL SOUTH,41605,41484,98.3,73.8,73.7,0.7,0.7,0.0,0.0,0.0,1.4,0.0,98.3,40885,30689,30654,0,0,0,599,310,310,2,40917,5976,24.6,73.7,14.4,0.0,0.0,0.0,1.4,10231,30654,0,0,0,599
E14000574,BLAYDON,41762,41477,94.3,51.1,50.3,7.9,7.9,0.1,0.4,0.8,5.0,0.1,97.7,39400,21320,21018,38,171,328,2077,3307,3307,30,40801,1,44.0,50.3,0.0,0.1,0.3,0.4,4.2,18382,21018,38,133,157,1749
E14000575,BLYTH VALLEY,39034,39020,98.7,31.2,16.3,7.2,7.2,0.0,0.1,0.1,1.3,0.0,100.0,38521,12191,6363,17,22,39,499,2821,2821,2,39017,0,82.4,16.3,0.0,0.0,0.0,0.0,1.2,32158,6363,17,5,17,460
E14000576,BOGNOR REGIS AND LITTLEHAMPTON,49780,49617,97.4,8.8,8.8,8.8,8.8,0.1,0.1,0.1,2.3,0.0,99.3,48467,4374,4374,48,58,74,1150,4374,4374,2,49438,0,88.6,8.8,0.0,0.1,0.0,0.0,2.2,44093,4374,48,10,16,1076
E14000577,BOLSOVER,45739,45637,94.6,36.6,32.7,13.5,13.5,0.0,0.2,0.4,5.2,0.1,98.6,43272,16745,14958,17,81,166,2365,6155,6155,44,45094,0,61.9,32.7,0.0,0.0,0.1,0.2,4.8,28314,14958,17,64,85,2199
E14000578,BOLTON NORTH EAST,43861,43784,99.1,92.3,90.2,4.7,89.0,0.0,0.1,0.4,0.7,0.0,99.4,43468,40479,39565,0,30,155,316,2067,39028,0,43608,0,8.9,90.2,0.0,0.0,0.1,0.3,0.4,3903,39565,0,30,125,161
E14000579,BOLTON SOUTH EAST,43868,43824,99.0,91.7,90.8,23.6,89.5,0.0,0.1,0.1,0.9,0.1,99.3,43437,40224,39814,0,36,41,387,10350,39261,26,43565,0,8.3,90.8,0.0,0.0,0.1,0.0,0.8,3623,39814,0,36,5,346
E14000580,BOLTON WEST,43809,43794,98.1,85.4,83.8,3.8,83.1,0.0,0.0,0.3,1.8,0.1,99.4,42992,37404,36712,10,19,126,802,1643,36394,23,43547,2406,14.3,83.8,5.5,0.0,0.0,0.2,1.5,6280,36712,10,9,107,676
E14000581,BOOTLE,46881,46836,99.4,92.6,92.4,47.4,92.4,0.0,0.0,0.1,0.5,0.0,99.6,46586,43391,43321,0,21,68,250,22228,43321,0,46675,0,7.0,92.4,0.0,0.0,0.0,0.1,0.4,3265,43321,0,21,47,182
E14000582,BOSTON AND SKEGNESS,50014,49480,89.2,12.6,7.9,4.5,4.5,0.8,2.2,3.9,9.7,2.7,96.5,44619,6310,3957,398,1076,1974,4861,2240,2240,1362,48285,3193,81.3,7.9,6.4,0.8,1.4,1.8,5.8,40662,3957,398,678,898,2887
E14000583,BOSWORTH,48006,47634,96.9,64.8,62.0,9.6,9.6,0.1,0.8,1.0,2.3,0.2,98.2,46530,31116,29740,25,401,487,1104,4587,4589,111,47160,0,35.0,62.0,0.0,0.1,0.8,0.2,1.3,16790,29740,25,376,86,617
E14000584,BOURNEMOUTH EAST,49307,49191,98.3,92.4,89.1,46.8,46.8,0.6,0.6,0.9,1.5,0.0,99.4,48462,45571,43908,293,293,432,729,23088,23088,0,49027,3,9.2,89.1,0.0,0.6,0.0,0.3,0.6,4554,43908,293,0,139,297
E14000585,BOURNEMOUTH WEST,49181,48788,98.8,83.9,80.3,46.5,46.5,0.0,0.0,0.0,0.4,0.0,99.1,48573,41274,39498,0,1,8,215,22886,22886,0,48736,84,18.5,80.3,0.2,0.0,0.0,0.0,0.4,9075,39498,0,1,7,207
E14000586,BRACKNELL,48001,47571,95.4,59.5,56.3,8.0,54.6,0.0,0.0,0.7,3.7,0.1,97.3,45787,28552,27006,1,23,357,1784,3833,26190,27,46725,0,39.1,56.3,0.0,0.0,0.0,0.7,3.0,18781,27006,1,22,334,1427
E14000587,BRADFORD EAST,41700,41682,98.1,89.1,85.5,2.8,85.1,0.0,0.0,0.1,1.8,0.0,98.3,40918,37155,35669,0,6,28,764,1186,35503,0,40987,10777,12.6,85.5,25.8,0.0,0.0,0.1,1.8,5249,35669,0,6,22,736
E14000588,BRADFORD SOUTH,42978,42962,98.4,86.7,83.1,5.0,82.1,0.0,0.1,0.2,1.6,0.0,99.2,42285,37266,35695,5,53,98,677,2137,35268,0,42648,948,15.3,83.1,2.2,0.0,0.1,0.1,1.3,6590,35695,5,48,45,579
E14000589,BRADFORD WEST,37216,36587,95.5,86.8,79.4,3.2,78.1,0.0,0.1,0.2,2.8,0.0,96.0,35558,32289,29566,1,36,92,1029,1195,29063,0,35735,3639,16.1,79.4,9.8,0.0,0.1,0.2,2.5,5992,29566,1,35,56,937
E14000590,BRAINTREE,44104,43936,95.6,26.1,26.1,26.0,26.0,0.1,0.6,1.1,4.0,0.3,98.4,42185,11509,11509,64,265,507,1751,11481,11481,127,43403,5680,69.6,26.1,12.9,0.1,0.5,0.5,2.8,30676,11509,64,201,242,1244
E14000591,BRENT CENTRAL,60495,59881,96.7,68.0,62.8,40.5,60.8,0.0,0.1,0.5,2.3,0.0,96.8,58501,41154,37967,2,58,329,1380,24487,36762,0,58546,0,33.9,62.8,0.0,0.0,0.1,0.4,1.7,20534,37967,2,56,271,1051
E14000592,BRENT NORTH,46033,45893,98.5,88.2,87.3,28.8,86.6,0.0,0.0,0.0,1.2,0.0,98.5,45345,40588,40168,0,9,15,548,13275,39860,0,45353,0,11.2,87.3,0.0,0.0,0.0,0.0,1.2,5177,40168,0,9,6,533
E14000593,BRENTFORD AND ISLEWORTH,52039,51755,98.3,88.3,88.1,14.7,88.1,0.0,0.0,0.1,1.2,0.0,98.4,51151,45965,45865,0,19,34,604,7637,45861,0,51189,0,10.2,88.1,0.0,0.0,0.0,0.0,1.1,5286,45865,0,19,15,570
E14000594,BRENTWOOD AND ONGAR,42400,42242,95.8,47.3,47.3,41.3,47.3,0.1,0.2,0.5,3.8,0.2,98.2,40613,20034,20034,39,99,191,1629,17529,20034,68,41642,659,48.5,47.3,1.6,0.1,0.1,0.2,3.4,20579,20034,39,60,92,1438
E14000595,BRIDGWATER AND WEST SOMERSET,53144,52961,91.3,26.9,18.5,13.8,13.8,0.7,1.9,3.5,8.3,0.9,97.3,48541,14294,9806,371,1022,1848,4420,7315,7315,501,51733,3901,72.9,18.5,7.3,0.7,1.2,1.6,4.8,38735,9806,371,651,826,2572
E14000596,BRIGG AND GOOLE,39333,39187,93.6,29.2,29.2,26.1,26.1,0.5,1.1,1.5,6.1,0.3,97.5,36803,11490,11490,212,437,604,2384,10252,10252,115,38363,19769,64.4,29.2,50.3,0.5,0.6,0.4,4.5,25313,11490,212,225,167,1780
E14000597,"BRIGHTON, KEMPTOWN",43776,43597,97.9,77.8,77.6,18.5,18.5,0.0,0.0,0.0,1.7,0.0,98.8,42856,34071,33954,0,3,17,741,8114,8114,6,43248,0,20.3,77.6,0.0,0.0,0.0,0.0,1.7,8902,33954,0,3,14,724
E14000598,"BRIGHTON, PAVILION",48879,48408,97.2,87.9,85.3,21.8,21.8,0.0,0.4,1.0,1.8,0.0,97.3,47511,42986,41681,2,192,513,897,10637,10638,3,47581,0,11.9,85.3,0.0,0.0,0.4,0.7,0.8,5830,41681,2,190,321,384
E14000599,BRISTOL EAST,44382,44232,97.3,91.2,91.1,43.5,43.5,0.0,0.2,0.7,2.3,0.0,97.4,43198,40487,40421,0,76,310,1034,19327,19327,15,43229,0,6.3,91.1,0.0,0.0,0.2,0.5,1.6,2777,40421,0,76,234,724
E14000600,BRISTOL NORTH WEST,43840,43805,98.2,89.8,88.7,19.2,19.2,0.0,0.0,0.4,1.7,0.0,98.8,43069,39356,38894,0,12,192,736,8423,8423,0,43298,38,9.5,88.7,0.1,0.0,0.0,0.4,1.2,4175,38894,0,12,180,544
E14000601,BRISTOL SOUTH,49853,49565,98.5,96.0,96.0,81.0,81.0,0.0,0.0,0.1,0.9,0.0,98.6,49119,47870,47868,6,14,59,446,40360,40360,0,49133,0,2.5,96.0,0.0,0.0,0.0,0.1,0.8,1251,47868,6,8,45,387
E14000602,BRISTOL WEST,56917,56688,94.6,89.2,87.5,54.8,54.8,0.0,0.0,0.4,5.0,0.0,94.6,53858,50744,49808,0,0,218,2830,31177,31177,8,53858,0,7.1,87.5,0.0,0.0,0.0,0.4,4.6,4050,49808,0,0,218,2612
E14000603,BROADLAND,44897,44699,91.9,16.3,12.7,9.4,9.4,0.4,1.4,2.6,7.6,2.0,98.0,41275,7322,5690,172,614,1152,3424,4226,4226,876,43988,99,79.3,12.7,0.2,0.4,1.0,1.2,5.1,35585,5690,172,442,538,2272
E14000604,BROMLEY AND CHISLEHURST,40522,40451,97.7,84.8,84.6,10.9,77.0,0.0,0.0,0.1,2.2,0.0,98.5,39574,34348,34285,0,0,39,877,4421,31184,1,39910,0,13.1,84.6,0.0,0.0,0.0,0.1,2.1,5289,34285,0,0,39,838
E14000605,BROMSGROVE,41894,41803,97.6,73.7,73.6,52.5,73.6,0.0,0.2,0.4,2.2,0.1,99.6,40901,30884,30847,17,76,158,902,22007,30854,39,41710,44,24.0,73.6,0.1,0.0,0.1,0.2,1.8,10054,30847,17,59,82,744
E14000606,BROXBOURNE,43163,43132,98.7,89.5,86.7,5.5,5.5,0.1,0.1,0.2,1.3,0.0,99.4,42581,38625,37428,22,33,70,551,2383,2383,2,42900,0,11.9,86.7,0.0,0.1,0.0,0.1,1.1,5153,37428,22,11,37,481
E14000607,BROXTOWE,43199,43123,99.0,92.7,91.5,6.5,6.5,0.0,0.1,0.2,0.8,0.0,99.6,42778,40034,39547,14,37,70,345,2800,2800,0,43015,0,7.5,91.5,0.0,0.0,0.1,0.1,0.6,3231,39547,14,23,33,275
E14000608,BUCKINGHAM,46104,45781,91.9,37.2,33.3,30.8,30.8,0.3,1.4,2.8,7.4,0.7,95.8,42372,17145,15337,143,664,1306,3409,14186,14186,302,44167,658,58.6,33.3,1.4,0.3,1.1,1.4,4.6,27035,15337,143,521,642,2103
E14000609,BURNLEY,41546,41486,98.6,82.0,82.0,1.8,82.0,0.1,0.1,0.3,1.3,0.0,99.7,40962,34065,34063,24,39,111,524,742,34062,16,41423,26018,16.6,82.0,62.6,0.1,0.0,0.2,1.0,6899,34063,24,15,72,413
E14000610,BURTON,47629,47500,96.3,43.7,39.5,35.4,35.4,0.2,0.6,1.1,3.4,0.2,99.2,45866,20837,18813,107,270,506,1634,16880,16880,78,47263,0,56.8,39.5,0.0,0.2,0.3,0.5,2.4,27053,18813,107,163,236,1128
E14000611,BURY NORTH,39768,39599,97.8,59.3,49.2,26.0,40.9,0.0,0.2,0.2,1.7,0.0,99.5,38904,23567,19578,9,63,94,695,10323,16267,14,39572,0,48.6,49.2,0.0,0.0,0.1,0.1,1.5,19326,19578,9,54,31,601
E14000612,BURY SOUTH,43973,43610,98.3,88.9,87.9,76.3,87.6,0.0,0.0,0.1,0.9,0.1,99.1,43221,39083,38674,0,3,32,389,33546,38522,36,43581,0,10.3,87.9,0.0,0.0,0.0,0.1,0.8,4547,38674,0,3,29,357
E14000613,BURY ST EDMUNDS,52773,52648,95.5,24.7,19.3,15.8,15.8,0.1,0.3,0.5,4.2,0.3,99.2,50414,13033,10163,76,158,279,2234,8340,8340,147,52341,0,76.3,19.3,0.0,0.1,0.2,0.2,3.7,40251,10163,76,82,121,1955
E14000614,CALDER VALLEY,48073,48014,93.3,35.5,35.3,10.1,10.1,0.2,0.6,1.1,6.6,0.1,98.8,44834,17049,16958,99,281,529,3180,4852,4852,54,47507,0,58.0,35.3,0.0,0.2,0.4,0.5,5.5,27876,16958,99,182,248,2651
E14000615,CAMBERWELL AND PECKHAM,54334,54107,96.5,83.5,82.9,47.1,82.7,0.0,0.1,0.3,3.1,0.0,96.5,52407,45395,45059,0,53,140,1700,25571,44926,0,52408,0,13.5,82.9,0.0,0.0,0.1,0.2,2.9,7348,45059,0,53,87,1560
E14000616,CAMBORNE AND REDRUTH,42717,42346,88.5,37.8,37.8,37.8,37.8,0.2,0.8,2.0,10.6,0.5,93.2,37818,16148,16142,80,359,861,4528,16142,16142,220,39812,829,50.7,37.8,1.9,0.2,0.7,1.2,8.6,21676,16142,80,279,502,3667
E14000617,CAMBRIDGE,52177,52062,98.6,91.3,86.8,31.8,31.8,0.0,0.0,0.1,1.2,0.0,98.6,51445,47632,45314,0,2,77,617,16618,16618,0,51464,251,11.8,86.8,0.5,0.0,0.0,0.1,1.0,6131,45314,0,2,75,540
E14000618,CANNOCK CHASE,44444,44330,98.4,28.5,28.4,6.2,28.2,0.0,0.1,0.1,1.4,0.1,99.6,43712,12650,12608,5,25,41,618,2765,12542,43,44279,0,70.0,28.4,0.0,0.0,0.0,0.0,1.3,31104,12608,5,20,16,577
E14000619,CANTERBURY,49735,49511,94.2,4.1,4.1,4.1,4.1,0.3,0.6,1.0,5.3,0.3,99.4,46866,2030,2030,127,302,484,2645,2031,2031,137,49451,8388,90.1,4.1,16.9,0.3,0.4,0.4,4.3,44836,2030,127,175,182,2161
E14000620,CARLISLE,42611,42522,97.9,65.1,58.4,5.4,5.4,0.2,0.5,0.8,1.9,0.2,99.1,41719,27746,24872,64,202,350,803,2288,2288,78,42228,0,39.5,58.4,0.0,0.2,0.3,0.3,1.1,16847,24872,64,138,148,453
E14000621,CARSHALTON AND WALLINGTON,41063,40991,98.5,86.8,86.4,8.6,86.2,0.0,0.0,0.2,1.3,0.0,98.9,40442,35636,35479,10,12,87,549,3524,35407,0,40596,0,12.1,86.4,0.0,0.0,0.0,0.2,1.1,4963,35479,10,2,75,462
E14000622,CASTLE POINT,38675,38411,98.7,45.7,45.7,2.7,2.7,0.0,0.0,0.0,0.6,0.0,99.0,38190,17689,17679,0,8,11,221,1035,1035,0,38284,0,53.0,45.7,0.0,0.0,0.0,0.0,0.5,20511,17679,0,8,3,210
E14000623,CENTRAL DEVON,42174,41970,78.2,22.8,22.8,21.3,21.3,1.9,5.5,10.6,21.3,2.3,92.7,32977,9600,9599,799,2315,4455,8993,8989,8989,949,39097,21739,55.4,22.8,51.5,1.9,3.6,5.1,10.8,23378,9599,799,1516,2140,4538
E14000624,CENTRAL SUFFOLK AND NORTH IPSWICH,44435,44255,93.9,42.8,41.0,27.7,27.7,0.3,0.7,1.5,5.7,0.5,98.6,41719,19004,18228,115,320,685,2536,12330,12330,239,43803,4754,52.9,41.0,10.7,0.3,0.5,0.8,4.2,23491,18228,115,205,365,1851
E14000625,CHARNWOOD,44057,43990,98.8,77.2,76.3,14.4,14.4,0.0,0.1,0.2,1.1,0.1,99.5,43513,34031,33601,11,39,83,477,6363,6363,62,43852,0,22.5,76.3,0.0,0.0,0.1,0.1,0.9,9912,33601,11,28,44,394
E14000626,CHATHAM AND AYLESFORD,42642,42565,98.8,88.0,84.6,7.1,7.1,0.0,0.1,0.3,1.0,0.0,99.3,42140,37513,36091,5,40,118,425,3047,3047,2,42354,2999,14.2,84.6,7.0,0.0,0.1,0.2,0.7,6049,36091,5,35,78,307
E14000627,CHEADLE,40307,40195,98.5,81.2,81.2,18.4,56.4,0.0,0.0,0.0,1.2,0.0,99.3,39711,32728,32728,1,1,8,484,7416,22747,1,40009,4282,17.3,81.2,10.6,0.0,0.0,0.0,1.2,6983,32728,1,0,7,476
E14000628,CHELMSFORD,49287,49196,98.4,85.5,82.5,52.3,52.3,0.0,0.0,0.0,1.4,0.0,98.9,48514,42124,40641,0,6,11,682,25790,25790,1,48725,0,16.0,82.5,0.0,0.0,0.0,0.0,1.4,7873,40641,0,6,5,671
E14000629,CHELSEA AND FULHAM,55931,55687,94.6,73.8,62.9,21.9,53.9,0.0,0.0,0.0,5.0,0.0,94.6,52910,41292,35207,0,0,1,2777,12226,30148,0,52912,0,31.7,62.9,0.0,0.0,0.0,0.0,5.0,17703,35207,0,0,1,2776
E14000630,CHELTENHAM,51241,51067,98.9,76.8,69.5,2.0,2.0,0.0,0.0,0.2,0.8,0.0,99.2,50667,39365,35595,2,18,105,400,1035,1035,4,50812,0,29.4,69.5,0.0,0.0,0.0,0.2,0.6,15072,35595,2,16,87,295
E14000631,CHESHAM AND AMERSHAM,40298,40253,94.4,48.0,47.5,7.2,7.2,0.0,1.2,2.2,5.5,0.1,99.4,38027,19362,19148,18,480,888,2226,2890,2896,48,40058,0,46.8,47.5,0.0,0.0,1.1,1.0,3.3,18879,19148,18,462,408,1338
E14000632,CHESTERFIELD,44816,44776,98.3,58.1,57.2,22.6,22.6,0.0,0.0,0.1,1.6,0.0,99.7,44047,26019,25625,0,0,45,729,10114,10114,1,44700,0,41.1,57.2,0.0,0.0,0.0,0.1,1.5,18422,25625,0,0,45,684
E14000633,CHICHESTER,53428,52822,92.3,27.0,24.6,23.2,23.2,0.3,0.7,1.4,6.5,0.7,98.2,49333,14430,13170,150,376,771,3489,12418,12418,372,52469,0,67.7,24.6,0.0,0.3,0.4,0.7,5.1,36163,13170,150,226,395,2718
E14000634,CHINGFORD AND WOODFORD GREEN,37958,37897,97.2,84.7,84.0,10.4,83.4,0.1,0.1,0.4,2.7,0.1,97.4,36887,32154,31901,34,55,167,1010,3946,31639,21,36986,0,13.1,84.0,0.0,0.1,0.1,0.3,2.2,4986,31901,34,21,112,843
E14000635,CHIPPENHAM,44920,44865,96.4,42.7,37.0,16.9,16.9,0.1,0.3,0.5,3.5,0.1,99.0,43297,19198,16639,43,117,206,1568,7600,7600,24,44485,0,59.3,37.0,0.0,0.1,0.2,0.2,3.0,26658,16639,43,74,89,1362
E14000636,CHIPPING BARNET,47280,47179,97.5,60.2,55.0,42.6,51.5,0.0,0.0,0.1,2.3,0.0,98.3,46082,28440,25999,0,4,56,1097,20153,24354,2,46488,0,42.5,55.0,0.0,0.0,0.0,0.1,2.2,20083,25999,0,4,52,1041
E14000637,CHORLEY,46859,46760,96.3,63.2,60.0,12.1,12.1,0.0,0.2,0.6,3.5,0.0,99.1,45114,29634,28129,23,86,281,1646,5661,5661,22,46449,14365,36.2,60.0,30.7,0.0,0.1,0.4,2.9,16985,28129,23,63,195,1365
E14000638,CHRISTCHURCH,41568,41432,96.2,45.7,45.6,15.5,15.5,0.0,0.0,0.1,3.5,0.1,99.6,39969,18991,18942,11,17,32,1463,6459,6459,27,41387,17,50.6,45.6,0.0,0.0,0.0,0.0,3.4,21027,18942,11,6,15,1431
E14000639,CITIES OF LONDON AND WESTMINSTER,81156,80781,89.0,71.0,70.5,66.1,70.1,0.0,0.0,0.0,10.5,0.0,89.0,72241,57613,57188,0,0,21,8540,53671,56878,0,72248,0,18.5,70.5,0.0,0.0,0.0,0.0,10.5,15053,57188,0,0,21,8519
E14000640,CITY OF CHESTER,45677,45590,96.8,51.9,38.1,28.8,28.8,0.1,0.2,0.8,3.0,0.3,98.7,44201,23721,17398,36,88,350,1389,13169,13169,151,45096,25,58.7,38.1,0.1,0.1,0.1,0.6,2.3,26803,17398,36,52,262,1039
E14000641,CITY OF DURHAM,42275,42221,95.1,3.8,3.6,3.4,3.4,0.0,0.2,0.2,4.7,0.2,98.3,40215,1591,1516,21,65,98,2006,1451,1451,78,41566,0,91.5,3.6,0.0,0.0,0.1,0.1,4.5,38699,1516,21,44,33,1908
E14000642,CLACTON,45136,45030,98.6,6.5,6.5,6.5,6.5,0.0,0.1,0.2,1.2,0.0,99.7,44490,2928,2928,20,29,86,540,2928,2928,10,44997,114,92.1,6.5,0.3,0.0,0.0,0.1,1.0,41562,2928,20,9,57,454
E14000643,CLEETHORPES,42259,42161,95.4,67.0,67.0,1.7,1.7,0.2,1.3,1.8,4.3,0.3,97.5,40329,28320,28316,100,564,765,1832,711,711,127,41188,11816,28.4,67.0,28.0,0.2,1.1,0.5,2.5,12013,28316,100,464,201,1067
E14000644,COLCHESTER,53617,53382,98.5,73.0,72.9,5.9,5.9,0.0,0.0,0.1,1.0,0.0,98.9,52830,39142,39082,3,9,79,552,3189,3189,8,53043,393,25.6,72.9,0.7,0.0,0.0,0.1,0.9,13748,39082,3,6,70,473
E14000645,COLNE VALLEY,50230,50164,95.6,57.0,56.9,14.9,14.9,0.1,0.4,1.1,4.2,0.0,98.6,48030,28637,28596,60,213,570,2134,7468,7468,22,49511,0,38.7,56.9,0.0,0.1,0.3,0.7,3.1,19434,28596,60,153,357,1564
E14000646,CONGLETON,47131,47025,94.5,47.9,41.1,36.0,36.0,0.1,0.3,0.7,5.3,0.1,99.1,44521,22598,19380,50,136,332,2504,16988,16988,57,46714,1,53.3,41.1,0.0,0.1,0.2,0.4,4.6,25141,19380,50,86,196,2172
E14000647,COPELAND,38502,38404,94.8,2.0,2.0,2.0,2.0,0.4,0.9,1.6,4.9,1.1,99.2,36519,753,753,145,355,630,1885,753,753,429,38201,0,92.9,2.0,0.0,0.4,0.5,0.7,3.3,35766,753,145,210,275,1255
E14000648,CORBY,53791,53716,98.8,68.7,68.7,24.0,24.0,0.0,0.2,0.2,1.1,0.1,99.3,53134,36951,36947,21,91,129,582,12915,12915,71,53404,0,30.1,68.7,0.0,0.0,0.1,0.1,0.8,16187,36947,21,70,38,453
E14000649,COVENTRY NORTH EAST,50444,50369,99.2,96.3,96.3,85.0,96.3,0.0,0.1,0.4,0.7,0.0,99.2,50029,48576,48570,2,55,179,340,42875,48570,1,50048,164,2.9,96.3,0.3,0.0,0.1,0.2,0.3,1459,48570,2,53,124,161
E14000650,COVENTRY NORTH WEST,45827,45775,99.4,95.7,95.4,91.7,95.4,0.0,0.1,0.2,0.5,0.0,99.5,45566,43849,43727,1,57,86,209,42042,43736,3,45597,1,4.0,95.4,0.0,0.0,0.1,0.1,0.3,1839,43727,1,56,29,123
E14000651,COVENTRY SOUTH,44936,44871,97.3,89.1,89.0,85.9,89.1,0.0,0.6,0.8,2.6,0.0,97.4,43716,40033,39983,0,285,374,1155,38580,40025,0,43765,2,8.3,89.0,0.0,0.0,0.6,0.2,1.7,3733,39983,0,285,89,781
E14000652,CRAWLEY,46149,46090,99.2,86.9,86.5,3.3,3.3,0.0,0.0,0.0,0.7,0.0,99.5,45790,40107,39921,5,7,23,300,1542,1542,12,45915,0,12.7,86.5,0.0,0.0,0.0,0.0,0.6,5869,39921,5,2,16,277
E14000653,CREWE AND NANTWICH,51063,50924,97.1,29.5,15.0,5.0,5.0,0.0,0.2,0.4,2.6,0.1,99.3,49577,15072,7640,11,88,203,1347,2552,2552,44,50719,1039,82.1,15.0,2.0,0.0,0.2,0.2,2.2,41937,7640,11,77,115,1144
E14000654,CROYDON CENTRAL,53591,53457,98.0,86.1,85.1,22.2,85.4,0.0,0.0,0.1,1.8,0.0,98.5,52501,46155,45584,1,6,37,956,11919,45781,3,52791,0,12.9,85.1,0.0,0.0,0.0,0.1,1.7,6917,45584,1,5,31,919
E14000655,CROYDON NORTH,59088,58949,96.3,89.5,88.8,37.8,88.8,0.0,0.0,0.3,3.5,0.0,96.4,56902,52861,52493,0,16,148,2047,22323,52493,9,56980,0,7.5,88.8,0.0,0.0,0.0,0.2,3.2,4409,52493,0,16,132,1899
E14000656,CROYDON SOUTH,48708,48591,96.2,81.3,81.2,10.2,80.5,0.0,0.0,0.2,3.6,0.0,97.3,46853,39585,39532,0,1,106,1738,4987,39221,0,47390,0,15.0,81.2,0.0,0.0,0.0,0.2,3.4,7321,39532,0,1,105,1632
E14000657,DAGENHAM AND RAINHAM,44080,43416,96.4,87.8,87.6,35.3,87.6,0.0,0.3,0.5,2.1,1.1,96.8,42512,38691,38619,14,143,222,904,15580,38604,476,42668,0,8.8,87.6,0.0,0.0,0.3,0.2,1.5,3893,38619,14,129,79,682
E14000658,DARLINGTON,44687,44646,99.0,92.9,92.7,1.7,1.7,0.0,0.3,0.5,0.9,0.0,99.1,44250,41529,41407,13,118,206,396,744,759,19,44293,9760,6.4,92.7,21.8,0.0,0.2,0.2,0.4,2843,41407,13,105,88,190
E14000659,DARTFORD,49591,49565,97.7,74.4,72.5,39.1,71.0,0.3,0.4,0.5,2.2,0.0,99.7,48472,36912,35934,130,202,236,1093,19411,35216,6,49461,0,25.3,72.5,0.0,0.3,0.1,0.1,1.7,12538,35934,130,72,34,857
E14000660,DAVENTRY,44052,43951,96.5,47.2,41.8,32.3,32.3,0.3,0.7,1.3,3.2,0.2,98.3,42528,20798,18408,134,297,562,1423,14246,14246,84,43292,321,54.8,41.8,0.7,0.3,0.4,0.6,2.0,24120,18408,134,163,265,861
E14000661,DENTON AND REDDISH,40473,40385,99.0,90.2,89.0,13.0,15.3,0.0,0.1,0.1,0.8,0.0,99.6,40050,36496,36024,0,25,50,335,5256,6212,0,40314,0,9.9,89.0,0.0,0.0,0.1,0.1,0.7,4026,36024,0,25,25,285
E14000662,DERBY NORTH,46377,45943,98.8,92.6,91.4,26.1,26.1,0.0,0.0,0.0,0.2,0.0,99.0,45842,42960,42410,0,0,14,101,12122,12122,0,45921,0,7.4,91.4,0.0,0.0,0.0,0.0,0.2,3432,42410,0,0,14,87
E14000663,DERBY SOUTH,47893,47801,98.9,93.3,92.9,32.8,32.8,0.0,0.0,0.0,0.9,0.0,98.9,47368,44695,44483,0,1,3,433,15690,15690,0,47386,0,6.0,92.9,0.0,0.0,0.0,0.0,0.9,2885,44483,0,1,2,430
E14000664,DERBYSHIRE DALES,37846,37711,90.4,12.7,12.6,11.6,11.6,0.6,1.7,3.3,9.2,1.3,97.0,34217,4811,4783,210,662,1251,3494,4390,4390,505,36706,0,77.8,12.6,0.0,0.6,1.2,1.6,5.9,29434,4783,210,452,589,2243
E14000665,DEVIZES,43486,43372,94.0,27.5,27.5,9.7,9.7,0.2,0.8,1.8,5.7,0.8,98.8,40874,11955,11952,68,366,784,2498,4235,4235,368,42983,0,66.5,27.5,0.0,0.2,0.7,1.0,3.9,28922,11952,68,298,418,1714
E14000666,DEWSBURY,45775,45679,98.1,77.4,77.4,32.2,32.2,0.0,0.1,0.2,1.7,0.0,99.3,44905,35411,35409,2,34,89,774,14751,14751,1,45438,0,20.7,77.4,0.0,0.0,0.1,0.1,1.5,9496,35409,2,32,55,685
E14000667,DON VALLEY,45048,44996,97.8,48.2,47.9,34.4,34.4,0.0,0.2,0.4,2.1,0.1,99.5,44047,21697,21592,18,102,173,949,15514,15514,25,44842,6680,49.8,47.9,14.8,0.0,0.2,0.2,1.7,22455,21592,18,84,71,776
E14000668,DONCASTER CENTRAL,48541,48397,99.3,83.1,83.1,62.1,62.1,0.0,0.1,0.1,0.4,0.0,99.4,48183,40349,40335,3,28,33,214,30124,30124,2,48261,9226,16.2,83.1,19.0,0.0,0.1,0.0,0.4,7848,40335,3,25,5,181
E14000669,DONCASTER NORTH,45068,45003,98.1,60.5,59.9,36.9,36.9,0.2,0.4,0.5,1.8,0.1,99.5,44192,27277,26990,72,182,230,811,16649,16649,35,44847,3741,38.2,59.9,8.3,0.2,0.2,0.1,1.3,17202,26990,72,110,48,581
E14000670,DOVER,46384,46244,94.9,44.1,44.1,13.2,13.2,0.5,0.8,1.1,4.8,0.2,98.9,44008,20449,20446,228,352,520,2236,6103,6103,81,45886,13750,50.8,44.1,29.6,0.5,0.3,0.4,3.7,23562,20446,228,124,168,1716
E14000671,DUDLEY NORTH,36358,36287,98.9,91.5,90.7,1.2,81.2,0.0,0.0,0.0,0.9,0.0,99.3,35975,33278,32973,0,0,10,312,435,29516,1,36108,2439,8.3,90.7,6.7,0.0,0.0,0.0,0.8,3002,32973,0,0,10,302
E14000672,DUDLEY SOUTH,35388,35297,99.5,94.2,92.9,1.7,91.4,0.0,0.0,0.0,0.3,0.0,99.7,35206,33330,32892,0,5,11,91,601,32336,12,35267,3437,6.5,92.9,9.7,0.0,0.0,0.0,0.2,2314,32892,0,5,6,80
E14000673,DULWICH AND WEST NORWOOD,49309,49163,97.0,79.3,76.9,9.7,75.6,0.0,0.0,0.0,2.7,0.0,97.0,47810,39078,37923,0,0,0,1353,4762,37299,0,47822,0,20.1,76.9,0.0,0.0,0.0,0.0,2.7,9887,37923,0,0,0,1353
E14000674,EALING CENTRAL AND ACTON,55957,55821,98.5,83.5,81.9,9.4,81.5,0.0,0.0,0.5,1.2,0.0,98.6,55139,46734,45823,0,16,281,682,5259,45607,0,55147,1,16.6,81.9,0.0,0.0,0.0,0.5,0.7,9316,45823,0,16,265,401
E14000675,EALING NORTH,47174,46848,98.5,86.5,83.7,18.1,84.1,0.0,0.0,0.5,0.8,0.0,98.6,46489,40793,39494,0,12,224,359,8548,39687,0,46497,0,14.8,83.7,0.0,0.0,0.0,0.4,0.3,6995,39494,0,12,212,135
E14000676,"EALING, SOUTHALL",35306,35084,97.4,46.1,44.7,14.1,44.3,0.0,0.0,0.2,2.0,0.0,97.4,34383,16272,15791,0,3,85,701,4978,15640,6,34384,0,52.7,44.7,0.0,0.0,0.0,0.2,1.7,18592,15791,0,3,82,616
E14000677,EASINGTON,39265,39245,97.4,43.7,34.1,26.9,26.9,0.2,0.2,0.3,2.6,0.0,99.8,38232,17160,13405,71,90,118,1013,10574,10574,7,39186,0,63.2,34.1,0.0,0.2,0.0,0.1,2.3,24827,13405,71,19,28,895
E14000678,EAST DEVON,51252,51105,93.2,53.7,52.4,46.5,46.5,0.4,1.2,2.2,6.5,0.2,97.9,47769,27523,26862,229,630,1152,3336,23829,23829,118,50164,13930,40.8,52.4,27.2,0.4,0.8,1.0,4.3,20907,26862,229,401,522,2184
E14000679,EAST HAM,53387,53325,98.3,89.0,86.3,67.5,83.7,0.0,0.1,0.7,1.5,0.0,98.3,52501,47494,46051,0,50,355,824,36044,44690,0,52503,0,12.1,86.3,0.0,0.0,0.1,0.6,0.9,6450,46051,0,50,305,469
E14000680,EAST HAMPSHIRE,44138,43841,93.1,41.2,37.5,18.9,18.9,0.1,0.4,1.1,6.2,0.6,97.1,41097,18165,16536,43,187,468,2744,8351,8351,253,42851,0,55.6,37.5,0.0,0.1,0.3,0.6,5.2,24561,16536,43,144,281,2276
E14000681,EAST SURREY,47450,47316,95.5,62.7,58.7,13.0,13.0,0.1,0.4,0.8,4.2,0.1,99.5,45303,29766,27832,47,197,364,2013,6159,6177,70,47208,0,36.8,58.7,0.0,0.1,0.3,0.4,3.5,17471,27832,47,150,167,1649
E14000682,EAST WORTHING AND SHOREHAM,43050,42992,99.0,90.3,90.2,27.7,27.7,0.0,0.0,0.1,0.9,0.0,99.6,42625,38867,38824,2,9,37,367,11935,11935,6,42894,0,8.8,90.2,0.0,0.0,0.0,0.1,0.8,3801,38824,2,7,28,330
E14000683,EAST YORKSHIRE,49579,49460,95.3,49.7,46.3,43.8,43.8,0.5,1.2,1.8,4.4,0.3,99.1,47254,24656,22939,266,613,917,2206,21706,21706,153,49153,19188,49.0,46.3,38.7,0.5,0.7,0.6,2.6,24315,22939,266,347,304,1289
E14000684,EASTBOURNE,51681,51615,99.3,15.8,15.8,15.8,15.8,0.0,0.0,0.0,0.6,0.0,99.7,51296,8183,8183,0,6,6,319,8183,8183,3,51550,0,83.4,15.8,0.0,0.0,0.0,0.0,0.6,43113,8183,0,6,0,313
E14000685,EASTLEIGH,49566,49438,97.5,76.4,73.4,16.6,28.9,0.0,0.0,0.1,2.2,0.0,98.8,48325,37887,36391,0,3,69,1113,8206,14326,4,48993,0,24.1,73.4,0.0,0.0,0.0,0.1,2.1,11934,36391,0,3,66,1044
E14000686,EDDISBURY,42235,42089,90.5,57.8,56.1,55.1,55.1,0.6,2.2,3.7,9.2,0.5,97.9,38203,24419,23689,274,933,1560,3886,23270,23270,231,41330,2390,34.4,56.1,5.7,0.6,1.6,1.5,5.5,14514,23689,274,659,627,2326
E14000687,EDMONTON,42196,42106,99.0,92.3,91.9,3.6,91.7,0.0,0.0,0.1,0.8,0.0,99.0,41781,38957,38791,0,20,60,325,1520,38711,0,41788,0,7.1,91.9,0.0,0.0,0.0,0.1,0.6,2990,38791,0,20,40,265
E14000688,ELLESMERE PORT AND NESTON,41620,41582,98.1,70.6,70.4,16.7,16.7,0.0,0.1,0.1,1.8,0.0,99.5,40840,29401,29311,14,43,58,742,6967,6967,5,41406,0,27.7,70.4,0.0,0.0,0.1,0.0,1.6,11529,29311,14,29,15,684
E14000689,ELMET AND ROTHWELL,45960,45874,96.3,66.6,65.2,50.3,64.3,0.1,0.2,0.5,3.5,0.2,98.6,44250,30613,29965,38,108,220,1624,23100,29540,81,45318,1675,31.1,65.2,3.6,0.1,0.2,0.2,3.1,14285,29965,38,70,112,1404
E14000690,ELTHAM,39544,39514,99.5,85.5,81.5,6.6,78.9,0.0,0.0,0.0,0.5,0.0,99.6,39327,33801,32212,0,7,7,187,2623,31204,0,39374,0,18.0,81.5,0.0,0.0,0.0,0.0,0.5,7115,32212,0,7,0,180
E14000691,ENFIELD NORTH,42364,42224,98.3,91.9,91.4,4.8,90.9,0.0,0.1,0.3,1.4,0.0,98.6,41650,38949,38720,16,25,113,574,2040,38508,0,41762,0,6.9,91.4,0.0,0.0,0.0,0.2,1.1,2930,38720,16,9,88,461
E14000692,"ENFIELD, SOUTHGATE",40819,40580,97.7,85.3,83.8,2.6,82.6,0.0,0.0,0.1,1.7,0.1,98.3,39894,34832,34200,0,0,52,686,1079,33699,46,40109,0,13.9,83.8,0.0,0.0,0.0,0.1,1.6,5694,34200,0,0,52,634
E14000693,EPPING FOREST,43004,42907,97.3,78.6,76.9,5.0,75.5,0.0,0.4,0.9,2.5,0.4,98.9,41827,33797,33072,21,184,379,1080,2133,32476,168,42531,0,20.4,76.9,0.0,0.0,0.4,0.5,1.6,8755,33072,21,163,195,701
E14000694,EPSOM AND EWELL,44506,44460,99.3,88.4,88.3,60.7,60.8,0.0,0.1,0.1,0.6,0.0,99.7,44204,39342,39286,0,50,56,256,27016,27046,22,44370,0,11.1,88.3,0.0,0.0,0.1,0.0,0.4,4918,39286,0,50,6,200
E14000695,EREWASH,44338,44257,99.3,86.2,85.5,32.0,32.0,0.0,0.0,0.1,0.5,0.0,99.8,44035,38219,37902,4,22,32,222,14179,14179,0,44239,0,13.8,85.5,0.0,0.0,0.0,0.0,0.4,6133,37902,4,18,10,190
E14000696,ERITH AND THAMESMEAD,44447,44387,99.3,85.8,84.5,45.1,83.9,0.0,0.0,0.2,0.6,0.0,99.3,44139,38150,37539,0,8,97,248,20067,37295,0,44139,2,14.8,84.5,0.0,0.0,0.0,0.2,0.3,6600,37539,0,8,89,151
E14000697,ESHER AND WALTON,47846,47732,98.8,81.9,80.2,9.0,9.0,0.0,0.0,0.0,1.0,0.0,99.3,47251,39176,38381,0,10,15,481,4307,4307,2,47527,0,18.5,80.2,0.0,0.0,0.0,0.0,1.0,8870,38381,0,10,5,466
E14000698,EXETER,47417,47095,96.6,88.5,88.3,67.2,67.2,0.0,0.1,1.5,2.7,0.0,97.0,45795,41971,41890,14,58,691,1300,31873,31873,4,45982,14698,8.2,88.3,31.0,0.0,0.1,1.3,1.3,3905,41890,14,44,633,609
E14000699,FAREHAM,43714,43672,98.5,86.6,83.9,4.2,4.2,0.0,0.1,0.3,1.4,0.0,99.5,43060,37871,36686,7,25,127,612,1820,1834,1,43496,0,14.6,83.9,0.0,0.0,0.0,0.2,1.1,6374,36686,7,18,102,485
E14000700,FAVERSHAM AND MID KENT,42927,42655,91.0,57.8,56.4,31.7,31.7,0.8,1.8,3.2,8.4,1.1,98.2,39053,24810,24210,329,771,1358,3602,13627,13627,490,42144,8233,34.6,56.4,19.2,0.8,1.0,1.4,5.2,14843,24210,329,442,587,2244
E14000701,FELTHAM AND HESTON,42317,42280,98.1,86.3,86.3,4.7,86.3,0.0,0.0,0.0,1.8,0.0,98.2,41520,36537,36532,0,6,20,760,1979,36532,0,41538,0,11.8,86.3,0.0,0.0,0.0,0.0,1.7,4988,36532,0,6,14,740
E14000702,FILTON AND BRADLEY STOKE,43710,43623,99.1,83.6,83.0,15.9,15.9,0.0,0.0,0.2,0.7,0.0,99.6,43324,36549,36282,8,18,73,299,6944,6944,0,43538,0,16.1,83.0,0.0,0.0,0.0,0.1,0.5,7042,36282,8,10,55,226
E14000703,FINCHLEY AND GOLDERS GREEN,50402,50251,97.7,59.3,53.9,8.4,51.1,0.0,0.0,0.0,2.0,0.0,98.5,49253,29913,27177,0,12,13,998,4256,25762,1,49630,0,43.8,53.9,0.0,0.0,0.0,0.0,2.0,22076,27177,0,12,1,985
E14000704,FOLKESTONE AND HYTHE,53621,53465,93.5,51.3,51.2,16.0,16.0,0.3,1.0,2.2,6.2,0.4,98.1,50151,27520,27440,182,550,1202,3314,8580,8580,227,52620,7302,42.4,51.2,13.6,0.3,0.7,1.2,3.9,22711,27440,182,368,652,2112
E14000705,FOREST OF DEAN,40787,40639,82.8,31.3,29.3,28.0,28.0,0.5,2.8,6.6,16.8,1.9,90.0,33774,12761,11950,216,1139,2710,6865,11423,11423,769,36717,497,53.5,29.3,1.2,0.5,2.3,3.9,10.2,21824,11950,216,923,1571,4155
E14000706,FYLDE,37191,36959,94.1,47.5,37.3,7.8,7.8,0.0,0.3,0.6,5.2,0.0,98.3,35009,17675,13888,18,94,238,1950,2891,2891,2,36546,8634,56.8,37.3,23.2,0.0,0.2,0.4,4.6,21121,13888,18,76,144,1712
E14000707,GAINSBOROUGH,44857,44597,86.9,34.4,32.3,20.7,20.7,2.1,4.2,6.3,12.5,1.4,97.3,38989,15425,14492,921,1870,2843,5608,9263,9263,606,43630,11558,54.6,32.3,25.8,2.1,2.1,2.2,6.2,24497,14492,921,949,973,2765
E14000708,GARSTON AND HALEWOOD,44910,44879,99.2,79.5,79.2,46.7,79.2,0.0,0.0,0.2,0.7,0.0,99.7,44545,35692,35575,3,20,72,334,20990,35555,0,44779,1,20.0,79.2,0.0,0.0,0.0,0.1,0.6,8970,35575,3,17,52,262
E14000709,GATESHEAD,45165,45115,98.7,90.8,89.2,5.1,5.1,0.0,0.0,0.1,1.2,0.0,98.8,44588,41030,40294,0,0,34,527,2303,2303,0,44632,0,9.5,89.2,0.0,0.0,0.0,0.1,1.1,4294,40294,0,0,34,493
E14000710,GEDLING,43173,43156,99.8,93.8,93.1,45.2,45.2,0.0,0.1,0.1,0.2,0.0,99.9,43073,40512,40207,4,25,35,83,19511,19511,4,43124,0,6.6,93.1,0.0,0.0,0.0,0.0,0.1,2866,40207,4,21,10,48
E14000711,GILLINGHAM AND RAINHAM,42429,42378,98.9,92.6,91.4,2.8,2.8,0.0,0.0,0.1,1.0,0.0,99.7,41965,39295,38764,0,1,34,413,1203,1203,0,42294,3008,7.5,91.4,7.1,0.0,0.0,0.1,0.9,3201,38764,0,1,33,379
E14000712,GLOUCESTER,52809,52734,98.6,89.3,87.6,9.1,9.1,0.0,0.2,0.6,1.2,0.0,98.9,52078,47144,46238,0,120,339,656,4823,4823,11,52241,1,11.1,87.6,0.0,0.0,0.2,0.4,0.6,5840,46238,0,120,219,317
E14000713,GOSPORT,43449,43417,99.7,89.1,89.0,3.6,3.6,0.0,0.0,0.0,0.3,0.0,99.9,43302,38708,38659,0,6,6,115,1585,1585,0,43402,0,10.7,89.0,0.0,0.0,0.0,0.0,0.3,4643,38659,0,6,0,109
E14000714,GRANTHAM AND STAMFORD,51065,50972,94.2,39.9,38.6,6.8,6.8,0.9,1.3,1.8,5.6,0.3,98.7,48104,20393,19732,471,642,905,2868,3486,3486,137,50425,0,55.6,38.6,0.0,0.9,0.3,0.5,3.8,28372,19732,471,171,263,1963
E14000715,GRAVESHAM,43293,43125,96.8,78.1,73.2,15.0,15.0,0.0,0.3,0.5,2.9,0.1,98.8,41889,33830,31679,18,117,196,1236,6499,6499,54,42771,0,23.6,73.2,0.0,0.0,0.2,0.2,2.4,10210,31679,18,99,79,1040
E14000716,GREAT GRIMSBY,37961,37943,99.1,95.0,94.8,1.7,1.7,0.0,0.0,0.1,0.9,0.0,99.5,37617,36080,36004,0,4,49,326,649,649,0,37781,10532,4.2,94.8,27.7,0.0,0.0,0.1,0.7,1613,36004,0,4,45,277
E14000717,GREAT YARMOUTH,45581,45421,97.6,54.2,54.2,5.0,5.0,0.0,0.1,0.3,2.1,0.1,99.4,44477,24705,24697,13,49,142,944,2264,2264,58,45330,0,43.4,54.2,0.0,0.0,0.1,0.2,1.8,19780,24697,13,36,93,802
E14000718,GREENWICH AND WOOLWICH,60523,60224,98.3,80.4,78.0,27.4,77.3,0.0,0.0,0.1,1.3,0.0,98.3,59464,48683,47194,0,2,33,760,16598,46771,0,59519,0,20.3,78.0,0.0,0.0,0.0,0.1,1.2,12270,47194,0,2,31,727
E14000719,GUILDFORD,44213,43735,95.3,68.8,66.5,5.3,5.3,0.2,0.4,1.0,3.6,0.3,98.1,42132,30412,29400,79,196,451,1603,2352,2352,138,43384,0,28.8,66.5,0.0,0.2,0.3,0.6,2.6,12732,29400,79,117,255,1152
E14000720,HACKNEY NORTH AND STOKE NEWINGTON,55887,55756,98.6,83.7,80.4,14.8,77.9,0.0,0.0,0.0,1.2,0.0,98.6,55086,46781,44924,0,0,1,670,8289,43524,0,55088,0,18.2,80.4,0.0,0.0,0.0,0.0,1.2,10162,44924,0,0,1,669
E14000721,HACKNEY SOUTH AND SHOREDITCH,58312,57889,96.2,70.8,65.4,36.0,62.2,0.0,0.0,0.3,3.1,0.0,96.2,56090,41287,38125,0,0,185,1799,20977,36254,0,56104,0,30.8,65.4,0.0,0.0,0.0,0.3,2.8,17965,38125,0,0,185,1614
E14000722,HALESOWEN AND ROWLEY REGIS,38903,38826,99.5,95.1,93.6,12.3,92.4,0.0,0.0,0.1,0.3,0.0,99.6,38692,37006,36422,0,0,21,134,4792,35933,0,38741,2,5.8,93.6,0.0,0.0,0.0,0.1,0.3,2270,36422,0,0,21,113
E14000723,HALIFAX,46341,46277,98.2,72.1,71.2,19.9,19.9,0.0,0.1,0.2,1.7,0.0,99.1,45512,33389,32992,6,34,79,765,9206,9206,0,45947,26,27.0,71.2,0.1,0.0,0.1,0.1,1.5,12520,32992,6,28,45,686
E14000724,HALTEMPRICE AND HOWDEN,40375,40146,97.0,78.4,78.4,78.4,78.4,0.4,0.7,1.0,2.5,0.1,98.8,39156,31646,31646,164,276,388,990,31645,31645,41,39891,10187,18.6,78.4,25.2,0.4,0.3,0.3,1.5,7510,31646,164,112,112,602
E14000725,HALTON,45277,44822,97.8,70.6,70.1,3.6,4.5,0.0,0.0,0.1,1.2,0.0,98.9,44265,31972,31737,0,22,45,557,1608,2038,0,44763,0,27.7,70.1,0.0,0.0,0.0,0.1,1.1,12528,31737,0,22,23,512
E14000726,HAMMERSMITH,54112,53606,95.6,77.6,70.2,32.4,64.9,0.0,0.0,0.2,3.4,0.0,95.6,51749,42002,37978,0,1,111,1857,17541,35106,0,51757,0,25.4,70.2,0.0,0.0,0.0,0.2,3.2,13771,37978,0,1,110,1746
E14000727,HAMPSTEAD AND KILBURN,62561,62294,98.8,88.1,87.7,43.5,87.8,0.0,0.0,0.0,0.8,0.0,98.8,61809,55103,54851,0,0,1,485,27234,54958,0,61817,3,11.1,87.7,0.0,0.0,0.0,0.0,0.8,6958,54851,0,0,1,484
E14000728,HARBOROUGH,45952,45581,97.5,67.1,62.6,5.9,5.9,0.0,0.1,0.2,1.7,0.0,98.8,44811,30820,28774,21,41,106,770,2729,2729,18,45393,0,34.9,62.6,0.0,0.0,0.0,0.1,1.4,16037,28774,21,20,65,664
E14000729,HARLOW,44091,43943,97.1,92.1,90.8,12.1,12.7,0.1,0.1,0.5,2.6,0.0,97.5,42793,40604,40044,24,40,225,1150,5321,5616,3,42992,217,6.2,90.8,0.5,0.1,0.0,0.4,2.1,2749,40044,24,16,185,925
E14000730,HARROGATE AND KNARESBOROUGH,47582,47480,97.5,80.6,78.2,27.7,27.7,0.0,0.1,0.3,2.3,0.1,98.6,46399,38342,37198,8,51,124,1081,13203,13204,39,46912,4017,19.3,78.2,8.4,0.0,0.1,0.2,2.0,9201,37198,8,43,73,957
E14000731,HARROW EAST,38468,38384,99.1,86.5,86.4,23.1,86.4,0.0,0.0,0.3,0.7,0.0,99.2,38107,33277,33232,0,0,112,277,8872,33231,18,38152,0,12.7,86.4,0.0,0.0,0.0,0.3,0.4,4875,33232,0,0,112,165
E14000732,HARROW WEST,42983,42909,98.0,85.4,85.3,9.7,85.3,0.0,0.0,0.2,1.8,0.0,98.0,42122,36690,36650,0,5,86,787,4185,36650,0,42126,0,12.7,85.3,0.0,0.0,0.0,0.2,1.6,5472,36650,0,5,81,701
E14000733,HARTLEPOOL,44621,44199,97.3,90.8,90.5,5.6,5.6,0.2,0.3,0.7,1.8,0.2,97.8,43415,40501,40393,108,156,306,784,2493,2493,95,43632,298,6.8,90.5,0.7,0.2,0.1,0.3,1.1,3022,40393,108,48,150,478
E14000734,HARWICH AND NORTH ESSEX,42316,41808,92.8,22.6,22.5,22.0,22.0,0.3,1.4,2.7,6.0,0.3,95.5,39252,9578,9529,136,591,1126,2556,9298,9298,136,40406,6677,70.2,22.5,15.8,0.3,1.1,1.3,3.4,29723,9529,136,455,535,1430
E14000735,HASTINGS AND RYE,52942,52762,97.8,5.7,5.7,5.7,5.7,0.0,0.1,0.2,1.9,0.0,99.6,51766,2997,2997,23,48,119,996,2997,2997,9,52751,270,92.1,5.7,0.5,0.0,0.0,0.1,1.7,48769,2997,23,25,71,877
E14000736,HAVANT,42503,42352,99.0,85.8,85.8,1.7,1.7,0.0,0.1,0.2,0.6,0.0,99.4,42087,36475,36469,0,25,64,265,738,738,4,42256,0,13.2,85.8,0.0,0.0,0.1,0.1,0.5,5618,36469,0,25,39,201
E14000737,HAYES AND HARLINGTON,42984,42780,97.3,89.2,89.2,24.4,89.2,0.0,0.0,0.5,2.2,0.0,97.3,41832,38355,38354,0,1,228,948,10495,38354,4,41833,0,8.1,89.2,0.0,0.0,0.0,0.5,1.7,3478,38354,0,1,227,720
E14000738,HAZEL GROVE,36052,35910,97.6,86.8,86.8,0.5,0.5,0.1,0.4,0.5,2.1,0.0,98.9,35169,31295,31294,21,148,190,741,173,173,6,35650,4216,10.7,86.8,11.7,0.1,0.4,0.1,1.5,3875,31294,21,127,42,551
E14000739,HEMEL HEMPSTEAD,45060,45010,98.2,85.3,82.4,14.1,14.1,0.0,0.2,0.3,1.7,0.1,99.2,44241,38441,37120,12,80,157,769,6343,6343,33,44699,0,15.8,82.4,0.0,0.0,0.2,0.2,1.4,7121,37120,12,68,77,612
E14000740,HEMSWORTH,43843,43577,94.3,21.6,20.9,16.1,16.1,0.1,0.5,0.7,5.1,0.3,98.2,41334,9466,9142,26,236,313,2243,7080,7080,116,43061,294,73.4,20.9,0.7,0.1,0.5,0.2,4.4,32192,9142,26,210,77,1930
E14000741,HENDON,55096,54805,97.5,64.0,61.3,19.5,61.2,0.0,0.0,0.0,1.9,0.0,98.4,53735,35277,33758,1,8,19,1070,10727,33695,0,54238,0,36.3,61.3,0.0,0.0,0.0,0.0,1.9,19977,33758,1,7,11,1051
E14000742,HENLEY,43937,43787,96.2,41.1,35.5,25.9,25.9,0.2,0.4,0.7,3.4,0.3,99.5,42288,18053,15601,66,155,314,1499,11379,11380,139,43701,0,60.7,35.5,0.0,0.2,0.2,0.4,2.7,26687,15601,66,89,159,1185
E14000743,HEREFORD AND SOUTH HEREFORDSHIRE,43877,43644,92.6,21.0,14.2,9.7,9.7,0.8,1.8,3.2,6.8,1.4,97.6,40639,9227,6252,366,803,1383,3005,4266,4266,616,42812,10,78.4,14.2,0.0,0.8,1.0,1.3,3.7,34387,6252,366,437,580,1622
E14000744,HERTFORD AND STORTFORD,48796,48733,97.5,84.9,81.1,11.4,11.4,0.1,0.2,0.3,2.3,0.1,98.7,47594,41451,39589,41,92,133,1139,5548,5548,68,48163,0,16.4,81.1,0.0,0.1,0.1,0.1,2.1,8005,39589,41,51,41,1006
E14000745,HERTSMERE,44657,44481,98.2,84.6,82.3,7.4,7.4,0.0,0.1,0.3,1.4,0.0,99.0,43871,37794,36754,3,59,117,610,3296,3296,12,44223,0,15.9,82.3,0.0,0.0,0.1,0.1,1.1,7117,36754,3,56,58,493
E14000746,HEXHAM,33745,33606,87.7,9.0,7.6,6.3,6.3,2.1,3.5,4.9,11.9,1.4,98.5,29588,3046,2555,698,1189,1638,4018,2113,2113,478,33231,3054,80.1,7.6,9.1,2.1,1.5,1.3,7.1,27033,2555,698,491,449,2380
E14000747,HEYWOOD AND MIDDLETON,48828,48784,97.6,70.5,59.8,5.4,5.4,0.0,0.1,0.2,2.3,0.0,99.2,47650,34430,29188,10,36,103,1134,2629,2634,24,48439,0,37.8,59.8,0.0,0.0,0.1,0.1,2.1,18462,29188,10,26,67,1031
E14000748,HIGH PEAK,42629,42438,93.5,11.2,7.6,4.2,4.2,0.3,0.6,1.1,6.0,0.5,98.8,39878,4779,3253,144,259,468,2560,1809,1809,210,42136,1,85.9,7.6,0.0,0.3,0.3,0.5,4.9,36625,3253,144,115,209,2092
E14000749,HITCHIN AND HARPENDEN,43580,43492,95.9,75.3,74.3,15.3,15.3,0.1,0.3,0.7,3.9,0.2,98.2,41811,32830,32393,52,140,291,1681,6673,6673,106,42776,0,21.6,74.3,0.0,0.1,0.2,0.3,3.2,9418,32393,52,88,151,1390
E14000750,HOLBORN AND ST PANCRAS,62305,61738,97.2,92.0,91.0,46.6,91.0,0.0,0.0,0.0,1.9,0.0,97.2,60568,57311,56717,0,0,4,1170,29034,56719,0,60570,0,6.2,91.0,0.0,0.0,0.0,0.0,1.9,3851,56717,0,0,4,1166
E14000751,HORNCHURCH AND UPMINSTER,46206,45988,97.6,85.9,84.8,3.3,84.1,0.1,0.2,0.4,2.0,0.1,98.6,45078,39678,39183,35,82,187,910,1533,38844,56,45552,0,12.8,84.8,0.0,0.1,0.1,0.2,1.6,5895,39183,35,47,105,723
E14000752,HORNSEY AND WOOD GREEN,53326,53224,98.0,78.0,75.9,1.8,73.8,0.0,0.0,0.3,1.8,0.0,98.1,52272,41589,40448,0,0,176,952,939,39346,0,52338,0,22.2,75.9,0.0,0.0,0.0,0.3,1.5,11824,40448,0,0,176,776
E14000753,HORSHAM,49702,49623,95.5,49.4,43.3,38.8,38.8,0.1,0.5,1.3,4.3,0.4,99.4,47461,24558,21537,40,259,645,2162,19283,19283,192,49411,0,52.2,43.3,0.0,0.1,0.4,0.8,3.1,25924,21537,40,219,386,1517
E14000754,HOUGHTON AND SUNDERLAND SOUTH,42547,42264,95.7,58.2,53.4,16.7,16.7,0.1,0.2,0.6,3.6,0.2,97.8,40714,24751,22731,29,69,265,1550,7091,7091,66,41621,0,42.3,53.4,0.0,0.1,0.1,0.5,3.0,17983,22731,29,40,196,1285
E14000755,HOVE,49332,49267,98.7,87.2,80.7,3.5,3.5,0.0,0.0,0.2,1.2,0.0,98.7,48690,43041,39825,0,2,95,577,1742,1742,0,48699,0,18.0,80.7,0.0,0.0,0.0,0.2,1.0,8865,39825,0,2,93,482
E14000756,HUDDERSFIELD,42598,42552,99.3,93.8,93.8,45.2,45.2,0.0,0.0,0.1,0.6,0.0,99.7,42317,39958,39950,1,15,47,235,19236,19236,1,42456,0,5.6,93.8,0.0,0.0,0.0,0.1,0.4,2367,39950,1,14,32,188
E14000757,HUNTINGDON,53481,53344,97.9,74.8,71.7,11.1,11.1,0.1,0.4,0.7,1.8,0.1,99.3,52364,40021,38358,63,201,358,980,5949,5949,66,53081,0,26.2,71.7,0.0,0.1,0.3,0.3,1.2,14006,38358,63,138,157,622
E14000758,HYNDBURN,42744,42464,97.7,77.0,69.7,16.4,16.4,0.0,0.1,0.2,1.6,0.0,99.3,41780,32898,29786,18,35,75,684,6997,7016,0,42445,32841,28.1,69.7,76.8,0.0,0.0,0.1,1.4,11994,29786,18,17,40,609
E14000759,ILFORD NORTH,40111,39958,98.6,89.4,89.1,40.0,88.9,0.0,0.1,0.3,1.0,0.0,98.8,39541,35869,35746,5,34,103,417,16041,35652,4,39622,0,9.5,89.1,0.0,0.0,0.1,0.2,0.8,3795,35746,5,29,69,314
E14000760,ILFORD SOUTH,45458,45363,97.7,85.9,85.7,39.8,85.7,0.0,0.0,0.1,2.1,0.0,97.9,44431,39048,38958,0,0,43,932,18087,38958,0,44520,0,12.0,85.7,0.0,0.0,0.0,0.1,2.0,5473,38958,0,0,43,889
E14000761,IPSWICH,51232,51150,98.3,87.4,84.4,12.8,12.8,0.0,0.1,0.4,1.6,0.0,98.5,50345,44755,43233,0,39,193,805,6569,6569,0,50438,0,13.9,84.4,0.0,0.0,0.1,0.3,1.2,7112,43233,0,39,154,612
E14000762,ISLE OF WIGHT,71730,71478,94.2,34.9,34.9,34.9,34.9,0.3,0.6,1.1,5.4,0.3,99.4,67599,25033,25033,180,430,773,3879,25033,25033,194,71333,0,59.3,34.9,0.0,0.3,0.3,0.5,4.3,42566,25033,180,250,343,3106
E14000763,ISLINGTON NORTH,52125,52098,97.4,91.5,91.3,8.3,91.3,0.0,0.0,0.1,2.5,0.0,97.5,50792,47672,47565,0,0,55,1306,4351,47566,0,50799,0,6.2,91.3,0.0,0.0,0.0,0.1,2.4,3227,47565,0,0,55,1251
E14000764,ISLINGTON SOUTH AND FINSBURY,54200,54134,94.2,73.4,72.9,31.4,72.9,0.0,0.0,0.0,5.7,0.0,94.2,51070,39776,39538,0,0,7,3064,16992,39538,1,51070,0,21.3,72.9,0.0,0.0,0.0,0.0,5.6,11532,39538,0,0,7,3057
E14000765,JARROW,39432,39426,97.9,75.5,75.2,2.3,2.3,0.1,0.3,0.5,2.1,0.0,99.1,38616,29781,29639,25,99,209,810,892,892,0,39078,0,22.8,75.2,0.0,0.1,0.2,0.3,1.5,8977,29639,25,74,110,601
E14000766,KEIGHLEY,40799,40760,95.4,79.1,75.6,3.0,73.6,0.2,0.4,1.0,4.5,0.1,98.5,38916,32262,30847,92,175,412,1844,1205,30015,44,40183,30350,19.8,75.6,74.4,0.2,0.2,0.6,3.5,8069,30847,92,83,237,1432
E14000767,KENILWORTH AND SOUTHAM,38694,38545,95.2,52.5,45.9,15.0,42.0,0.4,0.8,1.2,4.4,0.4,98.0,36829,20302,17749,138,313,474,1716,5787,16268,140,37925,177,49.3,45.9,0.5,0.4,0.5,0.4,3.2,19080,17749,138,175,161,1242
E14000768,KENSINGTON,65490,65413,97.2,91.4,87.8,33.6,84.9,0.0,0.0,0.1,2.7,0.0,97.2,63656,59890,57477,0,0,42,1757,22012,55572,0,63656,0,9.4,87.8,0.0,0.0,0.0,0.1,2.6,6179,57477,0,0,42,1715
E14000769,KETTERING,45819,45539,98.2,83.3,83.2,15.5,15.5,0.1,0.2,0.4,1.2,0.1,98.6,44974,38146,38109,23,100,167,565,7088,7088,65,45194,34,15.0,83.2,0.1,0.1,0.2,0.1,0.9,6865,38109,23,77,67,398
E14000770,KINGSTON AND SURBITON,49454,49331,98.8,93.4,91.3,3.3,89.4,0.0,0.0,0.1,0.9,0.0,99.0,48869,46190,45164,0,1,55,462,1620,44195,0,48949,0,7.5,91.3,0.0,0.0,0.0,0.1,0.8,3705,45164,0,1,54,407
E14000771,KINGSTON UPON HULL EAST,41413,41309,99.7,98.3,98.3,98.3,98.3,0.0,0.0,0.0,0.0,0.0,99.7,41300,40692,40692,0,0,9,9,40692,40692,0,41300,5129,1.5,98.3,12.4,0.0,0.0,0.0,0.0,608,40692,0,0,9,0
E14000772,KINGSTON UPON HULL NORTH,43236,42516,98.3,98.1,98.1,98.1,98.1,0.0,0.0,0.0,0.0,0.0,98.3,42512,42422,42422,0,0,0,4,42422,42422,0,42512,9251,0.2,98.1,21.4,0.0,0.0,0.0,0.0,90,42422,0,0,0,4
E14000773,KINGSTON UPON HULL WEST AND HESSLE,43698,43413,99.3,98.2,98.2,98.2,98.2,0.0,0.0,0.0,0.0,0.0,99.3,43398,42910,42910,1,1,3,15,42910,42910,0,43398,12197,1.1,98.2,27.9,0.0,0.0,0.0,0.0,488,42910,1,0,2,12
E14000774,KINGSWOOD,38721,38677,99.3,89.0,88.5,7.9,7.9,0.0,0.0,0.1,0.6,0.0,99.7,38463,34462,34255,1,1,28,214,3043,3043,0,38600,0,10.9,88.5,0.0,0.0,0.0,0.1,0.5,4208,34255,1,0,27,186
E14000775,KNOWSLEY,50370,50309,99.0,83.0,80.0,12.8,80.0,0.0,0.1,0.2,0.9,0.0,99.6,49868,41832,40289,4,58,88,441,6429,40289,23,50151,0,19.0,80.0,0.0,0.0,0.1,0.1,0.7,9579,40289,4,54,30,353
E14000776,LANCASTER AND FLEETWOOD,39043,38905,96.9,63.0,57.8,45.4,45.4,0.2,0.4,0.7,2.8,0.1,99.2,37824,24615,22566,84,160,281,1081,17725,17725,22,38728,471,39.1,57.8,1.2,0.2,0.2,0.3,2.0,15258,22566,84,76,121,800
E14000777,LEEDS CENTRAL,67355,66882,95.3,92.2,89.5,58.5,88.9,0.0,0.2,0.2,4.0,0.0,95.3,64206,62082,60276,0,125,136,2676,39433,59859,0,64207,0,5.8,89.5,0.0,0.0,0.2,0.0,3.8,3930,60276,0,125,11,2540
E14000778,LEEDS EAST,43905,43885,99.2,95.3,95.3,45.2,95.3,0.0,0.1,0.2,0.7,0.0,99.4,43574,41831,41831,0,33,107,311,19847,41829,7,43634,595,4.0,95.3,1.4,0.0,0.1,0.2,0.5,1743,41831,0,33,74,204
E14000779,LEEDS NORTH EAST,41356,41315,98.8,94.2,94.1,72.4,94.0,0.0,0.0,0.3,1.1,0.0,99.1,40844,38973,38896,2,4,117,471,29932,38891,1,40988,1217,4.7,94.1,2.9,0.0,0.0,0.3,0.9,1948,38896,2,2,113,354
E14000780,LEEDS NORTH WEST,36436,36416,97.4,77.1,73.0,29.8,70.7,0.0,0.2,0.5,2.5,0.0,98.3,35502,28110,26586,12,78,164,914,10849,25755,0,35815,9103,24.5,73.0,25.0,0.0,0.2,0.2,2.1,8916,26586,12,66,86,750
E14000781,LEEDS WEST,44638,44598,99.2,95.3,94.4,56.7,93.6,0.1,0.1,0.2,0.7,0.0,99.5,44269,42530,42144,23,52,75,329,25328,41797,0,44397,229,4.8,94.4,0.5,0.1,0.1,0.1,0.6,2125,42144,23,29,23,254
E14000782,LEICESTER EAST,41963,41928,99.3,93.6,93.6,38.1,38.1,0.0,0.0,0.1,0.7,0.0,99.6,41652,39293,39289,0,0,26,276,16007,16007,0,41797,0,5.6,93.6,0.0,0.0,0.0,0.1,0.6,2363,39289,0,0,26,250
E14000783,LEICESTER SOUTH,47142,47079,98.4,92.5,90.9,4.2,4.2,0.0,0.0,0.1,1.5,0.0,98.4,46374,43619,42854,0,0,47,705,1975,1975,1,46391,0,7.5,90.9,0.0,0.0,0.0,0.1,1.4,3520,42854,0,0,47,658
E14000784,LEICESTER WEST,44548,44485,99.6,94.9,94.6,3.8,3.8,0.0,0.0,0.1,0.3,0.0,99.7,44369,42273,42157,17,22,41,116,1695,1695,0,44399,0,5.0,94.6,0.0,0.0,0.0,0.0,0.2,2212,42157,17,5,19,75
E14000785,LEIGH,48141,48125,98.8,87.7,87.7,10.2,20.1,0.0,0.1,0.2,1.2,0.0,99.8,47548,42225,42205,18,43,81,577,4924,9664,24,48060,1,11.1,87.7,0.0,0.0,0.1,0.1,1.0,5343,42205,18,25,38,496
E14000786,LEWES,41121,41061,97.0,14.4,14.3,14.4,14.4,0.1,0.2,0.5,2.9,0.2,99.7,39875,5920,5876,26,101,224,1186,5919,5919,67,40984,0,82.7,14.3,0.0,0.1,0.2,0.3,2.3,33999,5876,26,75,123,962
E14000787,LEWISHAM EAST,46712,46507,98.4,81.8,79.5,3.5,77.4,0.0,0.0,0.1,1.1,0.0,98.7,45977,38212,37114,0,0,51,530,1647,36135,0,46110,0,19.0,79.5,0.0,0.0,0.0,0.1,1.0,8863,37114,0,0,51,479
E14000788,LEWISHAM WEST AND PENGE,50401,50252,95.1,72.5,72.0,16.2,71.8,0.0,0.0,0.4,4.6,0.0,95.4,47929,36563,36311,0,0,195,2323,8188,36163,0,48068,0,23.1,72.0,0.0,0.0,0.0,0.4,4.2,11618,36311,0,0,195,2128
E14000789,"LEWISHAM, DEPTFORD",57389,57001,94.8,61.9,60.8,24.1,60.7,0.0,0.0,0.1,4.5,0.0,94.8,54409,35528,34877,0,0,29,2592,13852,34845,0,54415,0,34.0,60.8,0.0,0.0,0.0,0.1,4.5,19532,34877,0,0,29,2563
E14000790,LEYTON AND WANSTEAD,40155,40097,97.1,87.0,85.4,11.0,84.2,0.0,0.0,0.4,2.7,0.0,97.2,39005,34937,34274,0,12,180,1092,4403,33792,7,39011,0,11.8,85.4,0.0,0.0,0.0,0.4,2.3,4731,34274,0,12,168,912
E14000791,LICHFIELD,43245,43149,96.8,69.7,66.0,17.8,63.4,0.2,0.5,0.9,2.9,0.3,99.4,41874,30150,28537,69,215,405,1275,7692,27425,113,42967,0,30.8,66.0,0.0,0.2,0.3,0.4,2.0,13337,28537,69,146,190,870
E14000792,LINCOLN,51105,51026,98.7,85.8,85.4,3.0,3.0,0.0,0.1,0.4,1.2,0.0,99.0,50435,43845,43635,15,37,199,591,1518,1518,7,50585,11740,13.3,85.4,23.0,0.0,0.0,0.3,0.8,6800,43635,15,22,162,392
E14000793,"LIVERPOOL, RIVERSIDE",59985,59534,87.8,71.5,65.2,22.0,60.6,0.0,0.0,1.0,11.5,0.0,88.2,52663,42864,39122,0,0,614,6871,13169,36346,0,52902,0,22.6,65.2,0.0,0.0,0.0,1.0,10.4,13541,39122,0,0,614,6257
E14000794,"LIVERPOOL, WALTON",42585,42238,98.4,84.9,84.1,7.2,83.2,0.0,0.1,0.1,0.8,0.0,98.7,41912,36174,35803,0,28,28,326,3045,35433,0,42036,0,14.3,84.1,0.0,0.0,0.1,0.0,0.7,6109,35803,0,28,0,298
E14000795,"LIVERPOOL, WAVERTREE",39767,39703,99.4,95.2,94.0,70.3,92.9,0.0,0.0,0.0,0.4,0.0,99.6,39545,37876,37362,0,0,16,158,27959,36936,3,39616,1,5.5,94.0,0.0,0.0,0.0,0.0,0.4,2183,37362,0,0,16,142
E14000796,"LIVERPOOL, WEST DERBY",40778,40703,99.5,92.6,92.2,47.7,92.0,0.0,0.0,0.0,0.3,0.0,99.7,40578,37763,37610,0,6,18,125,19461,37524,0,40668,0,7.3,92.2,0.0,0.0,0.0,0.0,0.3,2968,37610,0,6,12,107
E14000797,LOUGHBOROUGH,43939,43885,99.2,77.6,73.1,4.8,4.8,0.0,0.1,0.1,0.6,0.0,99.7,43607,34086,32118,12,38,64,278,2096,2096,10,43815,0,26.1,73.1,0.0,0.0,0.1,0.1,0.5,11489,32118,12,26,26,214
E14000798,LOUTH AND HORNCASTLE,47845,47672,89.4,18.4,18.1,4.9,4.9,0.8,2.1,3.7,10.2,1.2,97.9,42788,8795,8651,363,1015,1788,4884,2338,2339,557,46863,5271,71.3,18.1,11.0,0.8,1.4,1.6,6.5,34137,8651,363,652,773,3096
E14000799,LUDLOW,39178,38826,80.2,5.9,5.9,5.9,5.9,1.9,5.7,10.2,18.9,1.9,92.7,31416,2310,2310,757,2233,4001,7410,2310,2310,726,36333,28845,74.3,5.9,73.6,1.9,3.8,4.5,8.7,29106,2310,757,1476,1768,3409
E14000800,LUTON NORTH,38186,38149,99.9,96.4,94.9,0.8,0.8,0.0,0.0,0.0,0.0,0.0,99.9,38130,36796,36236,1,1,1,19,310,310,0,38146,0,5.0,94.9,0.0,0.0,0.0,0.0,0.0,1894,36236,1,0,0,18
E14000801,LUTON SOUTH,46741,46477,98.4,91.6,89.7,7.2,7.2,0.1,0.3,0.3,1.0,0.1,98.7,46015,42812,41928,33,139,155,462,3370,3370,38,46145,0,8.7,89.7,0.0,0.1,0.2,0.0,0.7,4087,41928,33,106,16,307
E14000802,MACCLESFIELD,44131,44000,95.3,70.1,70.1,4.7,4.7,0.2,0.8,1.5,4.4,0.4,98.4,42051,30951,30950,80,341,667,1949,2068,2068,172,43423,2445,25.2,70.1,5.5,0.2,0.6,0.7,2.9,11101,30950,80,261,326,1282
E14000803,MAIDENHEAD,44492,44372,96.0,73.8,69.5,9.7,23.9,0.1,0.2,0.6,3.7,0.1,98.2,42716,32814,30914,29,69,263,1656,4318,10625,25,43713,0,26.5,69.5,0.0,0.1,0.1,0.4,3.1,11802,30914,29,40,194,1393
E14000804,MAIDSTONE AND THE WEALD,47912,47749,93.8,75.0,69.6,28.4,28.4,0.1,0.9,1.6,5.9,0.3,98.0,44933,35923,33332,38,409,755,2816,13586,13586,161,46975,15443,24.2,69.6,32.2,0.1,0.8,0.7,4.3,11601,33332,38,371,346,2061
E14000805,MAKERFIELD,43490,43482,98.9,86.7,85.4,2.6,2.6,0.0,0.0,0.0,1.1,0.0,99.7,43001,37726,37144,1,6,19,481,1149,1149,9,43378,1067,13.5,85.4,2.5,0.0,0.0,0.0,1.1,5857,37144,1,5,13,462
E14000806,MALDON,40274,40147,94.0,31.6,29.3,27.0,27.0,0.2,0.8,1.6,5.7,0.3,98.6,37840,12733,11787,65,326,634,2307,10857,10857,126,39698,1016,64.7,29.3,2.5,0.2,0.6,0.8,4.2,26053,11787,65,261,308,1673
E14000807,MANCHESTER CENTRAL,71887,68878,89.0,67.5,65.8,47.1,61.0,0.0,0.0,0.5,6.8,0.0,89.3,64011,48532,47309,0,2,372,4867,33876,43857,0,64167,0,23.2,65.8,0.0,0.0,0.0,0.5,6.3,16702,47309,0,2,370,4495
E14000808,"MANCHESTER, GORTON",45240,43736,95.4,72.9,67.8,20.1,38.3,0.0,0.1,0.3,1.3,0.0,95.5,43158,32987,30661,1,40,128,578,9092,17344,0,43193,0,27.6,67.8,0.0,0.0,0.1,0.2,1.0,12497,30661,1,39,88,450
E14000809,"MANCHESTER, WITHINGTON",42287,42185,98.3,89.8,86.4,3.0,83.2,0.0,0.0,0.2,1.5,0.0,98.4,41571,37993,36549,8,8,83,614,1286,35178,0,41609,0,11.9,86.4,0.0,0.0,0.0,0.2,1.3,5022,36549,8,0,75,531
E14000810,MANSFIELD,49897,49814,99.4,90.5,88.3,9.4,9.4,0.0,0.0,0.0,0.4,0.0,99.8,49592,45163,44053,0,11,20,222,4706,4706,2,49787,0,11.1,88.3,0.0,0.0,0.0,0.0,0.4,5539,44053,0,11,9,202
E14000811,MEON VALLEY,41799,41698,93.8,62.4,60.0,8.0,8.1,0.3,1.0,1.8,5.9,0.6,98.0,39227,26088,25071,145,402,751,2471,3354,3375,249,40968,0,33.9,60.0,0.0,0.3,0.6,0.8,4.1,14156,25071,145,257,349,1720
E14000812,MERIDEN,49220,49146,98.0,85.9,85.2,18.3,84.8,0.0,0.2,0.7,1.8,0.0,98.9,48251,42286,41956,24,114,368,895,8993,41719,24,48655,2,12.8,85.2,0.0,0.0,0.2,0.5,1.1,6295,41956,24,90,254,527
E14000813,MID BEDFORDSHIRE,49549,49497,97.0,70.3,66.6,28.3,28.3,0.1,0.4,0.7,2.9,0.1,99.6,48057,34856,33001,56,176,369,1440,14012,14012,61,49356,1,30.4,66.6,0.0,0.1,0.2,0.4,2.2,15056,33001,56,120,193,1071
E14000814,MID DERBYSHIRE,38104,38048,98.1,65.8,58.6,20.4,20.4,0.1,0.1,0.2,1.8,0.0,99.7,37362,25066,22347,50,56,73,686,7767,7767,6,38008,0,39.4,58.6,0.0,0.1,0.0,0.0,1.6,15015,22347,50,6,17,613
E14000815,MID DORSET AND NORTH POOLE,36320,36113,94.3,49.7,49.7,10.2,10.2,0.0,0.1,0.3,5.1,0.1,97.9,34264,18064,18040,7,29,98,1849,3692,3692,54,35547,2,44.7,49.7,0.0,0.0,0.1,0.2,4.8,16224,18040,7,22,69,1751
E14000816,MID NORFOLK,48723,48559,92.3,24.8,24.8,24.8,24.8,0.4,1.3,2.2,7.4,1.1,98.1,44973,12087,12085,208,635,1064,3586,12083,12083,557,47821,4,67.5,24.8,0.0,0.4,0.9,0.9,5.2,32888,12085,208,427,429,2522
E14000817,MID SUSSEX,49559,49445,97.0,45.6,43.0,41.5,41.5,0.0,0.2,0.5,2.7,0.2,99.3,48090,22595,21317,19,103,257,1355,20581,20581,103,49229,0,54.0,43.0,0.0,0.0,0.2,0.3,2.2,26773,21317,19,84,154,1098
E14000818,MID WORCESTERSHIRE,46925,46655,95.7,26.2,21.1,11.6,11.8,0.1,0.5,0.9,3.8,0.3,99.0,44890,12291,9900,42,245,421,1765,5449,5528,131,46436,83,74.6,21.1,0.2,0.1,0.4,0.4,2.9,34990,9900,42,203,176,1344
E14000819,MIDDLESBROUGH,43197,43160,98.2,93.6,93.6,5.0,5.0,0.1,0.4,0.5,1.7,0.0,98.3,42440,40449,40425,56,192,231,720,2173,2173,5,42474,1242,4.7,93.6,2.9,0.1,0.3,0.1,1.1,2015,40425,56,136,39,489
E14000820,MIDDLESBROUGH SOUTH AND EAST CLEVELAND,44357,44282,96.1,85.1,85.0,4.9,4.9,0.1,0.5,1.2,3.7,0.2,97.6,42633,37732,37700,50,243,533,1649,2191,2191,95,43308,346,11.1,85.0,0.8,0.1,0.4,0.7,2.5,4933,37700,50,193,290,1116
E14000821,MILTON KEYNES NORTH,56695,56614,98.6,87.6,86.7,85.7,85.7,0.0,0.2,0.6,1.3,0.3,99.3,55897,49667,49133,11,106,333,717,48584,48584,188,56293,0,11.9,86.7,0.0,0.0,0.2,0.4,0.7,6764,49133,11,95,227,384
E14000822,MILTON KEYNES SOUTH,58914,58856,99.2,93.7,92.4,91.9,91.9,0.0,0.3,0.3,0.7,0.0,99.6,58446,55214,54440,20,164,182,410,54118,54118,22,58673,0,6.8,92.4,0.0,0.0,0.2,0.0,0.4,4006,54440,20,144,18,228
E14000823,MITCHAM AND MORDEN,42641,42606,98.8,89.4,88.8,15.7,88.8,0.0,0.0,0.0,1.1,0.0,98.8,42136,38140,37865,0,17,17,470,6680,37863,0,42142,0,10.0,88.8,0.0,0.0,0.0,0.0,1.1,4271,37865,0,17,0,453
E14000824,MOLE VALLEY,40690,40586,94.8,50.6,49.0,11.2,11.2,0.0,0.3,0.8,4.9,0.5,99.3,38578,20592,19921,15,126,332,2008,4564,4564,194,40400,0,45.9,49.0,0.0,0.0,0.3,0.5,4.1,18657,19921,15,111,206,1676
E14000825,MORECAMBE AND LUNESDALE,42577,42522,98.9,69.7,60.3,12.9,12.9,0.1,0.2,0.3,1.0,0.1,99.7,42110,29682,25674,62,64,113,412,5486,5486,24,42470,1080,38.6,60.3,2.5,0.1,0.0,0.1,0.7,16436,25674,62,2,49,299
E14000826,MORLEY AND OUTWOOD,46222,46188,98.2,83.3,81.6,64.3,68.0,0.0,0.2,0.3,1.7,0.0,99.7,45395,38505,37695,6,108,157,793,29718,31411,5,46073,0,16.7,81.6,0.0,0.0,0.2,0.1,1.4,7700,37695,6,102,49,636
E14000827,NEW FOREST EAST,40230,40112,93.3,37.7,32.2,4.0,4.1,0.4,0.7,1.4,6.4,0.8,98.5,37546,15163,12957,179,284,580,2566,1607,1636,307,39643,0,61.1,32.2,0.0,0.4,0.3,0.7,4.9,24589,12957,179,105,296,1986
E14000828,NEW FOREST WEST,42105,41946,94.4,18.7,18.6,18.5,18.5,0.4,0.7,1.1,5.2,0.6,99.2,39754,7855,7828,175,291,479,2192,7800,7800,270,41773,72,75.8,18.6,0.2,0.4,0.3,0.4,4.1,31926,7828,175,116,188,1713
E14000829,NEWARK,46914,46602,95.6,52.8,52.1,8.7,8.7,0.3,1.0,1.4,3.7,0.4,98.3,44848,24753,24421,146,447,674,1754,4067,4067,189,46105,557,43.5,52.1,1.2,0.3,0.6,0.5,2.3,20427,24421,146,301,227,1080
E14000830,NEWBURY,48054,47941,97.9,75.9,71.2,31.4,67.7,0.0,0.4,0.4,1.9,0.1,98.9,47035,36463,34236,12,179,209,906,15083,32531,64,47502,0,26.6,71.2,0.0,0.0,0.3,0.1,1.5,12799,34236,12,167,30,697
E14000831,NEWCASTLE UPON TYNE CENTRAL,42821,42529,95.8,85.4,83.1,40.0,40.0,0.0,0.0,0.1,3.5,0.0,95.9,41037,36552,35568,0,0,37,1492,17145,17145,0,41058,0,12.8,83.1,0.0,0.0,0.0,0.1,3.4,5469,35568,0,0,37,1455
E14000832,NEWCASTLE UPON TYNE EAST,42723,42619,97.4,73.5,69.0,17.8,17.8,0.0,0.0,0.1,2.4,0.0,97.6,41595,31395,29466,0,0,52,1024,7588,7588,0,41695,0,28.4,69.0,0.0,0.0,0.0,0.1,2.3,12129,29466,0,0,52,972
E14000833,NEWCASTLE UPON TYNE NORTH,44568,44487,97.9,65.9,62.2,31.6,31.6,0.0,0.1,0.2,1.9,0.0,99.6,43644,29352,27716,8,55,80,843,14091,14091,15,44375,0,35.7,62.2,0.0,0.0,0.1,0.1,1.7,15928,27716,8,47,25,763
E14000834,NEWCASTLE-UNDER-LYME,41411,40922,97.1,76.6,76.6,7.4,7.4,0.0,0.1,0.3,1.7,0.0,98.3,40228,31733,31703,4,40,105,694,3083,3083,10,40727,79,20.6,76.6,0.2,0.0,0.1,0.2,1.4,8525,31703,4,36,65,589
E14000835,NEWTON ABBOT,43382,43284,93.1,43.1,43.0,7.2,7.2,0.3,1.1,2.0,6.6,0.4,98.3,40401,18687,18670,110,495,846,2883,3126,3126,178,42653,6926,50.1,43.0,16.0,0.3,0.9,0.8,4.7,21731,18670,110,385,351,2037
E14000836,"NORMANTON, PONTEFRACT AND CASTLEFORD",50807,50710,98.0,69.9,69.3,29.2,29.2,0.0,0.3,0.4,1.8,0.0,98.6,49794,35500,35203,15,138,195,916,14848,14848,8,50074,282,28.7,69.3,0.6,0.0,0.2,0.1,1.4,14591,35203,15,123,57,721
E14000837,NORTH CORNWALL,44476,44178,88.9,40.7,40.7,40.7,40.7,0.5,1.2,2.5,10.4,0.9,94.4,39543,18088,18087,211,548,1098,4635,18087,18087,422,41990,1255,48.2,40.7,2.8,0.5,0.8,1.2,8.0,21456,18087,211,337,550,3537
E14000838,NORTH DEVON,46152,45937,88.1,21.0,21.0,21.0,21.0,1.2,3.0,5.6,11.4,1.4,94.5,40661,9711,9711,571,1391,2568,5276,9711,9711,637,43632,25745,67.1,21.0,55.8,1.2,1.8,2.6,5.9,30950,9711,571,820,1177,2708
E14000839,NORTH DORSET,42741,42603,91.9,23.0,23.0,22.9,22.9,0.2,0.9,1.9,7.7,0.3,99.0,39294,9829,9829,100,393,830,3309,9804,9804,121,42334,4179,68.9,23.0,9.8,0.2,0.7,1.0,5.8,29465,9829,100,293,437,2479
E14000840,NORTH DURHAM,42085,42055,93.8,25.0,19.8,7.8,7.8,0.0,0.5,1.6,6.1,0.2,98.0,39467,10502,8323,0,206,655,2588,3278,3278,79,41257,1311,74.0,19.8,3.1,0.0,0.5,1.1,4.6,31144,8323,0,206,449,1933
E14000841,NORTH EAST BEDFORDSHIRE,51153,51051,97.1,62.4,59.6,19.7,19.7,0.2,0.5,0.9,2.7,0.1,99.3,49694,31922,30470,81,238,440,1357,10085,10085,69,50809,394,37.6,59.6,0.8,0.2,0.3,0.4,1.8,19224,30470,81,157,202,917
E14000842,NORTH EAST CAMBRIDGESHIRE,53377,53171,95.5,56.4,54.3,28.0,28.0,0.4,0.9,1.4,4.1,0.4,98.6,50959,30086,28972,190,494,769,2212,14967,14967,202,52648,6124,41.2,54.3,11.5,0.4,0.6,0.5,2.7,21987,28972,190,304,275,1443
E14000843,NORTH EAST DERBYSHIRE,42461,42369,95.6,44.8,42.4,39.8,39.8,0.3,0.7,1.0,4.2,0.1,99.6,40606,19014,17986,121,277,433,1763,16913,16913,26,42303,0,53.3,42.4,0.0,0.3,0.4,0.4,3.1,22620,17986,121,156,156,1330
E14000844,NORTH EAST HAMPSHIRE,45152,44744,95.0,54.9,54.8,12.2,12.2,0.1,0.6,1.0,4.1,0.3,98.6,42907,24790,24760,44,261,452,1837,5530,5531,117,44506,1,40.2,54.8,0.0,0.1,0.5,0.4,3.1,18147,24760,44,217,191,1385
E14000845,NORTH EAST HERTFORDSHIRE,43693,43596,95.8,62.9,61.7,5.7,5.7,0.1,0.5,1.3,3.9,0.4,98.1,41874,27468,26973,54,230,575,1722,2489,2489,188,42862,100,34.1,61.7,0.2,0.1,0.4,0.8,2.6,14901,26973,54,176,345,1147
E14000846,NORTH EAST SOMERSET,41111,40963,93.4,66.3,61.9,37.3,37.3,0.2,0.4,0.9,6.2,0.3,96.3,38412,27243,25432,81,159,382,2551,15324,15324,137,39576,1,31.6,61.9,0.0,0.2,0.2,0.5,5.3,12980,25432,81,78,223,2169
E14000847,NORTH HEREFORDSHIRE,39757,39506,85.8,37.7,35.6,34.1,34.1,1.0,3.2,5.8,13.6,2.2,94.2,34116,14984,14151,400,1256,2302,5390,13562,13562,861,37454,2804,50.2,35.6,7.1,1.0,2.2,2.6,7.8,19965,14151,400,856,1046,3088
E14000848,NORTH NORFOLK,45466,45289,91.6,5.4,5.4,5.4,5.4,0.4,1.2,2.2,8.0,1.6,97.5,41636,2471,2471,190,548,980,3653,2464,2464,730,44336,0,86.1,5.4,0.0,0.4,0.8,1.0,5.9,39165,2471,190,358,432,2673
E14000849,NORTH SHROPSHIRE,48108,47910,88.1,16.2,10.2,6.2,6.2,0.8,2.3,4.4,11.5,0.4,97.9,42379,7787,4931,372,1094,2115,5531,2968,2968,213,47098,36485,77.8,10.2,75.8,0.8,1.5,2.1,7.1,37448,4931,372,722,1021,3416
E14000850,NORTH SOMERSET,45696,45593,94.0,65.2,60.1,18.3,18.3,0.2,0.7,1.4,5.8,0.3,96.8,42959,29803,27449,76,317,646,2634,8385,8385,143,44251,0,33.9,60.1,0.0,0.2,0.5,0.7,4.4,15510,27449,76,241,329,1988
E14000851,NORTH SWINDON,50693,50678,95.1,84.6,82.2,28.4,28.4,0.0,1.1,1.9,4.9,0.8,95.4,48202,42861,41662,8,534,970,2476,14403,14403,406,48349,0,12.9,82.2,0.0,0.0,1.0,0.9,3.0,6540,41662,8,526,436,1506
E14000852,NORTH THANET,46646,46517,95.5,32.0,31.7,32.0,32.0,0.0,0.9,1.6,4.2,0.0,99.5,44549,14923,14805,5,413,739,1968,14915,14915,10,46435,10338,63.8,31.7,22.2,0.0,0.9,0.7,2.6,29744,14805,5,408,326,1229
E14000853,NORTH TYNESIDE,51691,51592,99.1,70.3,65.4,23.6,23.6,0.0,0.0,0.1,0.7,0.0,99.7,51246,36358,33828,0,9,68,346,12207,12207,1,51516,0,33.7,65.4,0.0,0.0,0.0,0.1,0.5,17418,33828,0,9,59,278
E14000854,NORTH WARWICKSHIRE,40448,40401,97.9,56.5,55.2,15.8,54.2,0.1,0.3,0.5,2.0,0.1,99.6,39581,22863,22338,27,119,220,820,6387,21926,24,40288,0,42.6,55.2,0.0,0.1,0.2,0.2,1.5,17243,22338,27,92,101,600
E14000855,NORTH WEST CAMBRIDGESHIRE,60896,60496,96.7,58.7,55.4,38.6,38.6,0.2,0.4,0.6,2.7,0.2,98.7,58882,35719,33721,107,255,380,1614,23526,23526,109,60121,294,41.3,55.4,0.5,0.2,0.2,0.2,2.0,25161,33721,107,148,125,1234
E14000856,NORTH WEST DURHAM,44397,44336,95.3,48.1,45.7,45.6,45.6,0.5,0.9,1.4,4.6,0.4,99.4,42310,21345,20269,216,401,602,2026,20239,20239,172,44152,3,49.6,45.7,0.0,0.5,0.4,0.5,3.2,22041,20269,216,185,201,1424
E14000857,NORTH WEST HAMPSHIRE,48504,48360,94.1,54.3,51.9,19.3,19.6,0.2,0.8,1.9,5.6,0.8,97.8,45628,26345,25157,109,412,898,2732,9357,9521,391,47449,0,42.2,51.9,0.0,0.2,0.6,1.0,3.8,20471,25157,109,303,486,1834
E14000858,NORTH WEST LEICESTERSHIRE,45611,45542,97.7,71.9,70.3,6.4,6.4,0.1,0.5,0.7,2.1,0.1,99.6,44571,32773,32080,66,233,319,971,2929,2929,64,45414,0,27.4,70.3,0.0,0.1,0.4,0.2,1.4,12491,32080,66,167,86,652
E14000859,NORTH WEST NORFOLK,49126,48839,93.6,15.9,9.3,5.0,5.0,0.2,0.7,1.5,5.8,0.7,98.2,45980,7817,4560,102,349,721,2859,2455,2455,362,48257,0,84.3,9.3,0.0,0.2,0.5,0.8,4.4,41420,4560,102,247,372,2138
E14000860,NORTH WILTSHIRE,42025,41768,93.4,38.6,36.8,25.9,25.9,0.3,1.0,2.2,6.0,0.4,98.2,39256,16218,15479,110,441,916,2512,10903,10903,168,41286,2350,56.6,36.8,5.6,0.3,0.8,1.1,3.8,23777,15479,110,331,475,1596
E14000861,NORTHAMPTON NORTH,38799,38372,98.5,92.7,92.2,6.1,6.1,0.0,0.0,0.1,0.4,0.0,98.5,38220,35982,35787,0,0,21,152,2353,2353,0,38235,299,6.3,92.2,0.8,0.0,0.0,0.1,0.3,2433,35787,0,0,21,131
E14000862,NORTHAMPTON SOUTH,45494,44368,97.1,86.1,84.8,38.9,38.9,0.0,0.0,0.0,0.4,0.0,97.3,44165,39166,38591,0,1,9,203,17716,17717,0,44254,918,12.3,84.8,2.0,0.0,0.0,0.0,0.4,5574,38591,0,1,8,194
E14000863,NORWICH NORTH,38625,38585,99.3,89.1,87.3,2.9,2.9,0.0,0.0,0.0,0.6,0.0,99.8,38340,34427,33703,1,6,13,245,1128,1128,2,38543,0,12.0,87.3,0.0,0.0,0.0,0.0,0.6,4637,33703,1,5,7,232
E14000864,NORWICH SOUTH,39428,39380,98.8,86.7,84.1,13.2,13.2,0.0,0.0,0.5,1.1,0.0,99.1,38943,34177,33173,0,0,211,437,5195,5195,1,39080,0,14.6,84.1,0.0,0.0,0.0,0.5,0.6,5770,33173,0,0,211,226
E14000865,NOTTINGHAM EAST,44956,44773,98.5,94.0,92.5,34.1,34.1,0.0,0.0,0.0,1.1,0.0,98.6,44280,42280,41582,0,0,13,493,15351,15351,0,44323,0,6.0,92.5,0.0,0.0,0.0,0.0,1.1,2698,41582,0,0,13,480
E14000866,NOTTINGHAM NORTH,43548,43512,99.6,96.3,96.1,12.4,12.4,0.0,0.1,0.1,0.3,0.0,99.8,43388,41946,41838,0,32,35,124,5411,5411,0,43455,0,3.6,96.1,0.0,0.0,0.1,0.0,0.2,1550,41838,0,32,3,89
E14000867,NOTTINGHAM SOUTH,45454,45388,98.4,91.7,90.3,35.8,35.8,0.0,0.0,0.4,1.5,0.0,98.5,44713,41689,41044,6,17,174,675,16273,16273,0,44750,0,8.1,90.3,0.0,0.0,0.0,0.3,1.1,3669,41044,6,11,157,501
E14000868,NUNEATON,42600,42485,99.2,79.1,78.2,13.6,79.1,0.0,0.2,0.2,0.5,0.0,99.6,42265,33712,33298,3,80,90,220,5786,33711,7,42441,0,21.0,78.2,0.0,0.0,0.2,0.0,0.3,8967,33298,3,77,10,130
E14000869,OLD BEXLEY AND SIDCUP,36655,36559,97.8,70.8,68.1,25.5,66.7,0.0,0.0,0.1,2.0,0.0,98.9,35841,25936,24975,1,4,47,718,9360,24436,1,36247,0,29.6,68.1,0.0,0.0,0.0,0.1,1.8,10866,24975,1,3,43,671
E14000870,OLDHAM EAST AND SADDLEWORTH,42458,42401,97.2,68.6,67.6,4.7,4.7,0.1,0.3,0.5,2.7,0.0,99.6,41264,29126,28698,56,130,193,1137,1983,1983,1,42280,0,29.6,67.6,0.0,0.1,0.2,0.1,2.2,12566,28698,56,74,63,944
E14000871,OLDHAM WEST AND ROYTON,41174,41108,99.5,90.6,90.3,19.8,19.9,0.0,0.0,0.2,0.3,0.0,99.7,40976,37284,37200,0,0,62,132,8155,8187,1,41046,0,9.2,90.3,0.0,0.0,0.0,0.2,0.2,3776,37200,0,0,62,70
E14000872,ORPINGTON,38515,38475,96.2,87.1,87.1,46.2,66.5,0.1,0.7,1.2,3.7,0.2,98.2,37055,33561,33559,48,276,450,1420,17786,25594,66,37807,0,9.1,87.1,0.0,0.1,0.6,0.5,2.5,3496,33559,48,228,174,970
E14000873,OXFORD EAST,47740,47540,97.4,87.0,81.4,1.3,1.3,0.0,0.0,0.4,2.2,0.0,97.5,46493,41513,38838,0,21,211,1047,635,635,10,46558,0,16.0,81.4,0.0,0.0,0.0,0.4,1.8,7655,38838,0,21,190,836
E14000874,OXFORD WEST AND ABINGDON,46836,46575,98.2,83.9,78.7,5.9,5.9,0.0,0.0,0.1,1.2,0.0,98.9,46015,39307,36841,12,23,47,560,2765,2766,17,46298,0,19.6,78.7,0.0,0.0,0.0,0.1,1.1,9174,36841,12,11,24,513
E14000875,PENDLE,40687,40549,96.4,53.9,53.5,1.8,53.1,0.4,0.9,1.3,3.3,0.2,99.0,39225,21937,21785,166,369,511,1324,751,21599,96,40280,22055,42.9,53.5,54.2,0.4,0.5,0.3,2.0,17440,21785,166,203,142,813
E14000876,PENISTONE AND STOCKSBRIDGE,40486,40441,95.4,13.0,12.4,6.1,6.1,0.2,0.4,1.0,4.5,0.1,98.3,38632,5256,5010,68,154,393,1809,2480,2480,21,39813,0,83.0,12.4,0.0,0.2,0.2,0.6,3.5,33622,5010,68,86,239,1416
E14000877,PENRITH AND THE BORDER,40368,40087,83.7,10.5,9.1,7.1,7.1,3.0,5.7,8.5,15.6,2.7,95.0,33774,4251,3656,1207,2320,3417,6313,2857,2857,1093,38330,2952,74.6,9.1,7.3,3.0,2.8,2.7,7.2,30118,3656,1207,1113,1097,2896
E14000878,PETERBOROUGH,51652,51576,98.9,90.8,90.8,82.5,82.5,0.1,0.2,0.4,0.9,0.1,99.6,51109,46923,46904,36,127,195,467,42601,42601,30,51436,0,8.1,90.8,0.0,0.1,0.2,0.1,0.5,4205,46904,36,91,68,272
E14000879,"PLYMOUTH, MOOR VIEW",42440,42388,98.5,89.0,89.0,4.8,4.8,0.0,0.0,0.5,1.3,0.0,99.2,41822,37785,37781,2,21,222,566,2019,2019,9,42086,18573,9.5,89.0,43.8,0.0,0.0,0.5,0.8,4041,37781,2,19,201,344
E14000880,"PLYMOUTH, SUTTON AND DEVONPORT",50491,50366,97.6,90.2,87.9,0.5,0.5,0.0,0.1,0.9,2.2,0.1,97.7,49259,45535,44392,0,74,467,1107,277,277,29,49343,10197,9.6,87.9,20.2,0.0,0.1,0.8,1.3,4867,44392,0,74,393,640
E14000881,POOLE,48991,48604,97.5,73.9,71.8,0.7,0.7,0.0,0.0,0.1,1.7,0.0,98.2,47761,36201,35176,0,1,31,843,331,331,6,48116,9,25.7,71.8,0.0,0.0,0.0,0.1,1.7,12585,35176,0,1,30,812
E14000882,POPLAR AND LIMEHOUSE,76824,76665,95.7,80.2,79.4,70.0,78.8,0.0,0.0,0.3,4.1,0.0,95.7,73483,61585,61014,0,1,220,3182,53760,60544,0,73500,0,16.2,79.4,0.0,0.0,0.0,0.3,3.9,12469,61014,0,1,219,2962
E14000883,PORTSMOUTH NORTH,41797,41770,98.7,95.9,94.9,6.6,6.6,0.0,0.2,0.4,1.2,0.0,98.8,41267,40088,39656,0,85,155,503,2738,2738,0,41285,0,3.9,94.9,0.0,0.0,0.2,0.2,0.8,1611,39656,0,85,70,348
E14000884,PORTSMOUTH SOUTH,48841,48710,96.8,94.0,91.3,27.9,27.9,0.0,0.0,0.2,3.0,0.0,96.9,47269,45907,44599,0,3,85,1441,13604,13604,1,47323,0,5.5,91.3,0.0,0.0,0.0,0.2,2.8,2670,44599,0,3,82,1356
E14000885,PRESTON,41691,41489,98.2,76.5,75.1,2.1,2.1,0.0,0.0,0.1,1.3,0.0,99.0,40949,31914,31320,0,1,59,540,875,875,2,41276,27072,23.1,75.1,64.9,0.0,0.0,0.1,1.2,9629,31320,0,1,58,481
E14000886,PUDSEY,42226,42155,98.8,85.6,83.4,54.1,81.8,0.0,0.0,0.1,1.1,0.0,99.5,41702,36145,35223,3,9,33,453,22828,34525,0,42007,9428,15.3,83.4,22.3,0.0,0.0,0.1,1.0,6479,35223,3,6,24,420
E14000887,PUTNEY,44204,44062,98.0,84.5,73.3,42.3,63.5,0.0,0.0,0.1,1.7,0.0,98.0,43301,37368,32397,0,4,51,761,18716,28077,0,43311,0,24.7,73.3,0.0,0.0,0.0,0.1,1.6,10904,32397,0,4,47,710
E14000888,RAYLEIGH AND WICKFORD,42371,42242,98.5,37.7,35.3,27.6,27.6,0.0,0.0,0.1,1.2,0.0,99.6,41753,15955,14962,0,21,40,489,11682,11682,14,42189,1,63.2,35.3,0.0,0.0,0.0,0.0,1.1,26791,14962,0,21,19,449
E14000889,READING EAST,48774,48482,97.9,87.1,84.0,5.4,81.8,0.0,0.0,0.0,1.5,0.0,98.0,47732,42463,40981,0,0,1,750,2658,39903,0,47811,0,13.8,84.0,0.0,0.0,0.0,0.0,1.5,6751,40981,0,0,1,749
E14000890,READING WEST,46517,46443,99.3,89.0,85.0,8.6,82.5,0.0,0.0,0.1,0.6,0.0,99.5,46173,41419,39546,1,9,48,270,4000,38361,2,46268,0,14.2,85.0,0.0,0.0,0.0,0.1,0.5,6627,39546,1,8,39,222
E14000891,REDCAR,41392,41275,98.5,94.0,92.8,0.8,0.8,0.0,0.3,0.5,1.2,0.2,98.7,40781,38910,38428,0,111,215,494,318,318,64,40863,245,5.7,92.8,0.6,0.0,0.3,0.3,0.7,2353,38428,0,111,104,279
E14000892,REDDITCH,39304,39210,97.4,79.2,79.0,5.7,79.1,0.0,0.2,0.4,2.4,0.1,99.2,38266,31145,31069,16,95,158,944,2221,31073,39,38993,85,18.3,79.0,0.2,0.0,0.2,0.2,2.0,7197,31069,16,79,63,786
E14000893,REIGATE,44174,44099,97.2,74.5,71.4,17.9,18.0,0.0,0.2,0.3,2.6,0.1,99.7,42945,32925,31555,14,76,126,1154,7928,7937,34,44024,0,25.8,71.4,0.0,0.0,0.1,0.1,2.3,11390,31555,14,62,50,1028
E14000894,RIBBLE VALLEY,46509,46365,93.8,44.2,43.9,18.3,18.3,0.5,1.2,2.1,5.9,0.3,99.0,43624,20544,20439,211,566,993,2741,8496,8499,152,46027,30630,49.9,43.9,65.9,0.5,0.8,0.9,3.8,23185,20439,211,355,427,1748
E14000895,RICHMOND (YORKS),48506,48254,88.4,15.0,8.8,5.2,5.2,1.9,4.0,6.0,11.1,1.7,97.4,42893,7265,4289,920,1916,2918,5361,2530,2530,826,47233,21301,79.6,8.8,43.9,1.9,2.1,2.1,5.0,38604,4289,920,996,1002,2443
E14000896,RICHMOND PARK,51573,51526,98.3,86.5,83.9,9.7,82.4,0.0,0.0,0.2,1.6,0.0,98.6,50718,44589,43283,0,10,110,808,5025,42512,1,50834,0,14.4,83.9,0.0,0.0,0.0,0.2,1.4,7435,43283,0,10,100,698
E14000897,ROCHDALE,46851,46692,98.2,73.3,66.2,17.5,17.5,0.0,0.1,0.4,1.4,0.0,99.4,46026,34325,31031,4,57,210,666,8212,8212,23,46561,0,32.0,66.2,0.0,0.0,0.1,0.3,1.0,14995,31031,4,53,153,456
E14000898,ROCHESTER AND STROOD,48419,48280,96.4,75.2,70.6,15.8,15.8,0.0,0.5,1.1,3.3,0.2,98.5,46689,36398,34182,24,220,543,1591,7649,7649,92,47681,301,25.8,70.6,0.6,0.0,0.4,0.7,2.2,12507,34182,24,196,323,1048
E14000899,ROCHFORD AND SOUTHEND EAST,48287,47945,97.3,79.6,75.9,45.3,45.3,0.0,0.0,0.1,2.0,0.0,97.6,46992,38458,36652,1,14,25,953,21889,21889,18,47113,0,21.4,75.9,0.0,0.0,0.0,0.0,1.9,10340,36652,1,13,11,928
E14000900,ROMFORD,43509,43269,98.4,88.4,85.7,7.1,83.4,0.0,0.0,0.3,1.0,0.0,98.6,42820,38471,37291,7,7,115,449,3100,36289,7,42909,0,12.7,85.7,0.0,0.0,0.0,0.2,0.8,5529,37291,7,0,108,334
E14000901,ROMSEY AND SOUTHAMPTON NORTH,37807,37751,93.8,71.5,69.8,14.2,34.5,0.2,0.6,1.5,6.0,0.4,98.5,35469,27021,26401,66,215,549,2282,5351,13037,166,37250,0,24.0,69.8,0.0,0.2,0.4,0.9,4.6,9068,26401,66,149,334,1733
E14000902,ROSSENDALE AND DARWEN,45435,45220,94.9,54.4,48.5,9.3,9.3,0.1,0.7,1.1,4.6,0.2,98.7,43113,24721,22042,51,334,518,2107,4231,4236,83,44829,13938,46.4,48.5,30.7,0.1,0.6,0.4,3.5,21071,22042,51,283,184,1589
E14000903,ROTHER VALLEY,43585,43516,98.2,48.3,42.6,14.8,14.8,0.0,0.1,0.2,1.6,0.1,99.8,42821,21058,18572,19,53,92,695,6438,6438,31,43477,478,55.6,42.6,1.1,0.0,0.1,0.1,1.4,24249,18572,19,34,39,603
E14000904,ROTHERHAM,40173,40127,99.0,82.0,81.9,19.7,19.7,0.0,0.0,0.0,0.9,0.0,99.7,39779,32961,32919,0,2,15,348,7908,7908,0,40065,0,17.1,81.9,0.0,0.0,0.0,0.0,0.8,6860,32919,0,2,13,333
E14000905,RUGBY,45921,45827,98.4,76.0,72.7,15.8,69.9,0.1,0.2,0.3,1.3,0.0,99.4,45209,34889,33383,51,113,156,618,7262,32111,10,45650,1,25.8,72.7,0.0,0.1,0.1,0.1,1.0,11826,33383,51,62,43,462
E14000906,"RUISLIP, NORTHWOOD AND PINNER",40876,40739,98.4,80.0,77.8,7.5,76.0,0.0,0.1,0.3,1.2,0.0,98.8,40235,32712,31821,14,41,137,504,3054,31082,3,40399,0,20.6,77.8,0.0,0.0,0.1,0.2,0.9,8414,31821,14,27,96,367
E14000907,RUNNYMEDE AND WEYBRIDGE,46649,46507,97.4,70.7,67.4,5.0,5.0,0.0,0.0,0.5,2.3,0.0,98.6,45448,32973,31423,8,20,244,1059,2331,2331,14,46003,0,30.1,67.4,0.0,0.0,0.0,0.5,1.7,14025,31423,8,12,224,815
E14000908,RUSHCLIFFE,44258,44180,97.8,79.8,76.3,39.2,39.2,0.1,0.3,0.6,2.0,0.1,99.6,43274,35305,33770,51,128,258,906,17351,17351,55,44063,1029,21.5,76.3,2.3,0.1,0.2,0.3,1.5,9504,33770,51,77,130,648
E14000909,RUTLAND AND MELTON,46532,46380,93.0,32.6,32.4,8.4,8.4,0.5,1.2,2.2,6.6,0.9,98.0,43296,15160,15076,233,569,1009,3084,3908,3908,436,45622,1301,60.6,32.4,2.8,0.5,0.7,0.9,4.5,28220,15076,233,336,440,2075
E14000910,SAFFRON WALDEN,49170,48965,93.7,48.1,43.8,33.6,33.6,0.2,0.8,2.2,5.9,0.7,97.4,46072,23638,21554,122,390,1065,2893,16527,16527,333,47916,906,49.9,43.8,1.8,0.2,0.5,1.4,3.7,24518,21554,122,268,675,1828
E14000911,SALFORD AND ECCLES,61382,61341,95.7,81.4,81.4,56.5,81.4,0.0,1.1,2.7,4.3,0.0,95.8,58717,49990,49981,0,667,1655,2624,34690,49981,0,58788,0,14.2,81.4,0.0,0.0,1.1,1.6,1.6,8736,49981,0,667,988,969
E14000912,SALISBURY,44509,44423,97.3,71.6,71.6,60.0,60.0,0.1,0.3,0.6,2.5,0.2,99.6,43323,31887,31877,28,120,250,1100,26689,26689,110,44344,61,25.7,71.6,0.1,0.1,0.2,0.3,1.9,11446,31877,28,92,130,850
E14000913,SCARBOROUGH AND WHITBY,49599,49486,94.2,3.6,3.6,3.6,3.6,0.6,1.1,1.6,5.5,0.6,98.4,46746,1788,1788,291,536,787,2740,1786,1786,315,48789,1479,90.6,3.6,3.0,0.6,0.5,0.5,3.9,44958,1788,291,245,251,1953
E14000914,SCUNTHORPE,39675,39538,98.2,78.0,78.0,3.2,3.2,0.2,0.3,0.6,1.4,0.0,99.4,38972,30947,30945,79,135,227,566,1261,1261,11,39436,20837,20.2,78.0,52.5,0.2,0.1,0.2,0.9,8027,30945,79,56,92,339
E14000915,SEDGEFIELD,40269,40220,91.4,21.0,13.6,5.1,5.1,0.8,1.7,3.0,8.5,0.4,96.9,36800,8446,5475,327,676,1206,3420,2058,2058,171,39027,2347,77.8,13.6,5.8,0.8,0.9,1.3,5.5,31325,5475,327,349,530,2214
E14000916,SEFTON CENTRAL,37464,37396,98.1,80.1,80.1,58.4,80.1,0.0,0.0,0.2,1.7,0.0,99.6,36763,30002,30000,1,9,78,633,21873,30000,6,37298,0,18.1,80.1,0.0,0.0,0.0,0.2,1.5,6763,30000,1,8,69,555
E14000917,SELBY AND AINSTY,45901,45663,93.1,21.0,20.9,20.7,20.8,0.7,1.3,2.0,6.4,0.6,98.0,42738,9633,9589,300,590,936,2925,9504,9543,266,44979,7678,72.2,20.9,16.7,0.7,0.6,0.8,4.3,33149,9589,300,290,346,1989
E14000918,SEVENOAKS,40943,40823,95.3,55.5,55.5,31.5,55.5,0.1,0.3,0.8,4.5,0.2,99.5,38999,22727,22725,30,130,314,1824,12881,22724,71,40734,0,39.7,55.5,0.0,0.1,0.2,0.4,3.7,16274,22725,30,100,184,1510
E14000919,SHEFFIELD CENTRAL,51340,50889,92.4,69.2,64.5,19.8,19.8,0.0,0.0,1.0,6.7,0.0,92.5,47459,35516,33128,1,2,536,3430,10175,10175,0,47483,198,27.9,64.5,0.4,0.0,0.0,1.0,5.6,14331,33128,1,1,534,2894
E14000920,SHEFFIELD SOUTH EAST,41030,41001,99.0,50.9,43.2,19.0,19.0,0.0,0.0,0.1,0.9,0.0,99.8,40630,20867,17741,2,10,27,371,7814,7814,10,40941,0,55.8,43.2,0.0,0.0,0.0,0.0,0.8,22889,17741,2,8,17,344
E14000921,"SHEFFIELD, BRIGHTSIDE AND HILLSBOROUGH",46392,46371,99.3,76.6,76.4,19.3,19.3,0.0,0.0,0.3,0.6,0.0,99.5,46081,35515,35464,0,5,151,290,8944,8944,0,46145,0,22.9,76.4,0.0,0.0,0.0,0.3,0.3,10617,35464,0,5,146,139
E14000922,"SHEFFIELD, HALLAM",37988,37957,97.6,32.3,28.1,12.3,12.3,0.1,0.2,0.3,2.3,0.1,99.7,37076,12275,10670,36,69,99,881,4671,4671,44,37882,0,69.5,28.1,0.0,0.1,0.1,0.1,2.1,26406,10670,36,33,30,782
E14000923,"SHEFFIELD, HEELEY",44119,44066,99.1,58.0,55.0,5.4,5.4,0.0,0.0,0.0,0.8,0.0,99.7,43722,25577,24260,0,0,4,344,2362,2362,0,43965,0,44.1,55.0,0.0,0.0,0.0,0.0,0.8,19462,24260,0,0,4,340
E14000924,SHERWOOD,45781,45599,97.6,71.3,70.4,13.2,13.2,0.1,0.3,0.5,2.0,0.1,99.2,44677,32634,32224,48,148,215,922,6064,6064,42,45436,0,27.2,70.4,0.0,0.1,0.2,0.1,1.5,12453,32224,48,100,67,707
E14000925,SHIPLEY,42013,41994,96.8,71.4,63.0,8.5,60.2,0.1,0.2,0.4,3.1,0.0,98.5,40671,30017,26470,35,88,172,1323,3555,25301,2,41374,19842,33.8,63.0,47.2,0.1,0.1,0.2,2.7,14201,26470,35,53,84,1151
E14000926,SHREWSBURY AND ATCHAM,48822,48607,90.2,36.6,25.2,18.5,18.5,0.5,1.6,3.5,9.3,0.5,95.8,44048,17856,12283,220,789,1689,4559,9022,9022,232,46762,42284,65.1,25.2,86.6,0.5,1.2,1.8,5.9,31765,12283,220,569,900,2870
E14000927,SITTINGBOURNE AND SHEPPEY,49728,49538,95.9,55.4,47.6,11.6,11.6,0.1,0.4,1.0,3.8,0.1,99.2,47669,27554,23649,65,209,485,1869,5745,5745,28,49309,15953,48.3,47.6,32.1,0.1,0.3,0.6,2.8,24020,23649,65,144,276,1384
E14000928,SKIPTON AND RIPON,47214,46930,89.4,19.5,15.8,12.5,12.5,1.4,2.9,4.5,10.0,1.1,96.8,42207,9189,7454,667,1355,2110,4723,5906,5917,523,45707,16894,73.6,15.8,35.8,1.4,1.5,1.6,5.5,34753,7454,667,688,755,2613
E14000929,SLEAFORD AND NORTH HYKEHAM,53180,52950,94.2,31.3,29.6,6.9,6.9,0.8,1.4,2.1,5.4,0.5,98.6,50101,16655,15764,407,768,1125,2849,3693,3693,284,52456,1694,64.6,29.6,3.2,0.8,0.7,0.7,3.2,34337,15764,407,361,357,1724
E14000930,SLOUGH,52188,52054,99.4,93.8,91.1,47.1,48.1,0.0,0.0,0.0,0.3,0.0,99.6,51875,48954,47546,1,1,13,179,24578,25094,0,51958,0,8.3,91.1,0.0,0.0,0.0,0.0,0.3,4329,47546,1,0,12,166
E14000931,SOLIHULL,43400,43357,98.5,95.1,94.0,54.9,93.3,0.0,0.0,0.7,1.4,0.0,98.5,42763,41282,40817,0,2,299,594,23838,40498,6,42763,1,4.5,94.0,0.0,0.0,0.0,0.7,0.7,1946,40817,0,2,297,295
E14000932,SOMERTON AND FROME,49921,49654,84.5,32.3,31.3,11.7,11.7,0.7,2.9,6.7,14.9,1.3,94.0,42200,16100,15637,356,1465,3358,7454,5840,5840,659,46902,3086,53.2,31.3,6.2,0.7,2.2,3.8,8.2,26563,15637,356,1109,1893,4096
E14000933,SOUTH BASILDON AND EAST THURROCK,42718,42652,97.5,70.2,67.7,3.6,3.6,0.0,0.2,0.6,2.3,0.1,99.4,41664,29998,28911,12,87,256,988,1536,1536,63,42455,0,29.9,67.7,0.0,0.0,0.2,0.4,1.7,12753,28911,12,75,169,732
E14000934,SOUTH CAMBRIDGESHIRE,50497,50377,96.7,60.3,58.3,20.8,20.8,0.2,0.3,1.0,3.1,0.2,98.7,48825,30431,29447,79,170,483,1552,10525,10525,99,49836,184,38.4,58.3,0.4,0.2,0.2,0.6,2.1,19378,29447,79,91,313,1069
E14000935,SOUTH DERBYSHIRE,46615,46226,95.0,42.6,37.5,32.1,32.1,0.2,0.6,0.9,4.1,0.7,98.6,44306,19842,17499,73,283,436,1920,14969,14969,313,45952,0,57.5,37.5,0.0,0.2,0.5,0.3,3.2,26807,17499,73,210,153,1484
E14000936,SOUTH DORSET,45808,45635,96.4,5.6,5.6,5.6,5.6,0.1,0.3,0.6,3.2,0.3,99.3,44167,2584,2584,62,132,257,1468,2584,2584,149,45468,5,90.8,5.6,0.0,0.1,0.2,0.3,2.6,41583,2584,62,70,125,1211
E14000937,SOUTH EAST CAMBRIDGESHIRE,51220,50863,96.1,55.2,51.5,20.9,20.9,0.2,0.4,0.8,3.2,0.2,98.9,49247,28260,26390,96,203,431,1616,10710,10713,82,50661,8430,44.6,51.5,16.5,0.2,0.2,0.4,2.3,22857,26390,96,107,228,1185
E14000938,SOUTH EAST CORNWALL,43368,43145,90.4,37.8,37.2,23.5,23.5,0.4,1.0,1.8,9.1,0.6,96.1,39210,16406,16115,155,431,760,3935,10187,10187,267,41697,7770,53.3,37.2,17.9,0.4,0.6,0.8,7.3,23095,16115,155,276,329,3175
E14000939,SOUTH HOLLAND AND THE DEEPINGS,47982,47810,90.5,11.3,8.2,6.5,6.5,0.4,1.4,2.6,9.2,1.0,98.7,43404,5436,3940,186,691,1234,4406,3096,3096,503,47380,218,82.2,8.2,0.5,0.4,1.1,1.1,6.6,39464,3940,186,505,543,3172
E14000940,SOUTH LEICESTERSHIRE,46282,46168,97.3,63.9,60.5,40.3,40.3,0.1,0.3,0.4,2.5,0.0,98.6,45011,29594,28013,54,122,197,1157,18629,18629,19,45612,0,36.7,60.5,0.0,0.1,0.1,0.2,2.1,16998,28013,54,68,75,960
E14000941,SOUTH NORFOLK,49472,49347,91.6,15.9,15.0,12.9,12.9,0.4,1.2,2.5,8.2,1.5,98.3,45308,7872,7403,182,597,1231,4039,6378,6378,762,48630,15,76.6,15.0,0.0,0.4,0.8,1.3,5.7,37905,7403,182,415,634,2808
E14000942,SOUTH NORTHAMPTONSHIRE,52337,52040,96.0,55.4,49.1,41.2,41.2,0.1,1.4,1.8,3.4,0.5,97.5,50258,28995,25692,61,709,943,1782,21583,21583,248,51017,335,46.9,49.1,0.6,0.1,1.2,0.4,1.6,24566,25692,61,648,234,839
E14000943,SOUTH RIBBLE,43691,43605,96.6,68.9,66.8,21.6,21.6,0.1,0.5,1.0,3.2,0.0,98.9,42204,30099,29178,34,216,449,1401,9441,9441,18,43210,15082,29.8,66.8,34.5,0.1,0.4,0.5,2.2,13026,29178,34,182,233,952
E14000944,SOUTH SHIELDS,40614,40605,99.0,84.4,83.8,1.2,1.2,0.0,0.1,0.2,1.0,0.0,99.5,40207,34285,34050,15,47,83,398,495,495,1,40403,0,15.2,83.8,0.0,0.0,0.1,0.1,0.8,6157,34050,15,32,36,315
E14000945,SOUTH STAFFORDSHIRE,40861,40783,94.4,42.5,37.3,33.9,34.0,0.1,0.4,1.2,5.4,0.1,99.2,38570,17378,15233,57,169,501,2213,13841,13912,41,40515,2250,57.1,37.3,5.5,0.1,0.3,0.8,4.2,23337,15233,57,112,332,1712
E14000946,SOUTH SUFFOLK,42778,42615,94.8,15.2,15.0,10.9,10.9,0.3,0.8,1.1,4.8,0.4,99.0,40546,6516,6397,144,323,462,2069,4642,4642,160,42340,3208,79.8,15.0,7.5,0.3,0.4,0.3,3.8,34149,6397,144,179,139,1607
E14000947,SOUTH SWINDON,46999,46968,91.3,85.8,83.6,12.2,12.2,0.0,0.4,1.6,8.6,0.6,91.9,42915,40344,39293,14,171,732,4053,5736,5736,269,43177,0,7.7,83.6,0.0,0.0,0.3,1.2,7.1,3622,39293,14,157,561,3321
E14000948,SOUTH THANET,48007,47724,97.2,55.2,55.0,55.1,55.1,0.1,0.3,0.6,2.2,0.0,99.1,46647,26515,26399,47,128,282,1077,26450,26450,9,47585,11570,42.2,55.0,24.1,0.1,0.2,0.3,1.7,20248,26399,47,81,154,795
E14000949,SOUTH WEST BEDFORDSHIRE,47409,47343,98.6,75.2,72.7,7.1,7.1,0.0,0.1,0.2,1.3,0.2,99.4,46737,35630,34443,8,29,77,606,3351,3351,72,47120,0,25.9,72.7,0.0,0.0,0.0,0.1,1.1,12294,34443,8,21,48,529
E14000950,SOUTH WEST DEVON,41258,41196,93.3,75.1,74.1,18.8,18.8,0.1,0.8,2.8,6.6,0.7,97.2,38476,30970,30583,49,310,1165,2720,7740,7740,279,40116,12383,19.1,74.1,30.0,0.1,0.6,2.1,3.8,7893,30583,49,261,855,1555
E14000951,SOUTH WEST HERTFORDSHIRE,45512,45378,96.7,71.2,69.9,13.9,14.0,0.1,0.3,0.4,3.0,0.1,99.3,44007,32425,31834,66,122,188,1371,6332,6349,49,45216,0,26.7,69.9,0.0,0.1,0.1,0.1,2.6,12173,31834,66,56,66,1183
E14000952,SOUTH WEST NORFOLK,48934,48641,91.1,13.8,11.6,9.0,9.0,0.8,1.8,3.1,8.3,1.5,98.0,44556,6768,5672,385,881,1495,4085,4401,4401,726,47945,2286,79.5,11.6,4.7,0.8,1.0,1.3,5.3,38884,5672,385,496,614,2590
E14000953,SOUTH WEST SURREY,45130,45013,95.5,22.2,18.0,5.6,5.6,0.0,0.2,0.4,4.2,0.3,99.6,43101,10011,8141,18,83,184,1912,2508,2508,120,44931,0,77.5,18.0,0.0,0.0,0.1,0.2,3.8,34960,8141,18,65,101,1728
E14000954,SOUTH WEST WILTSHIRE,47032,46941,95.9,59.9,59.8,10.6,10.6,0.3,0.5,0.9,3.9,0.2,98.8,45114,28193,28145,126,251,419,1827,4997,4997,98,46472,1278,36.1,59.8,2.7,0.3,0.3,0.4,3.0,16969,28145,126,125,168,1408
E14000955,"SOUTHAMPTON, ITCHEN",49144,49038,97.7,92.2,91.3,23.9,88.2,0.0,0.0,0.3,2.1,0.0,97.9,48028,45305,44884,2,6,123,1010,11762,43345,0,48116,0,6.4,91.3,0.0,0.0,0.0,0.2,1.8,3144,44884,2,4,117,887
E14000956,"SOUTHAMPTON, TEST",47644,47595,99.2,97.8,97.0,64.3,90.9,0.0,0.0,0.4,0.7,0.0,99.2,47273,46581,46216,0,1,173,322,30653,43320,6,47278,0,2.2,97.0,0.0,0.0,0.0,0.4,0.3,1057,46216,0,1,172,149
E14000957,SOUTHEND WEST,40903,40825,98.5,65.0,55.4,17.3,17.3,0.0,0.0,0.0,1.3,0.0,99.1,40293,26600,22650,0,0,0,532,7061,7061,2,40516,157,43.1,55.4,0.4,0.0,0.0,0.0,1.3,17643,22650,0,0,0,532
E14000958,SOUTHPORT,43091,42665,97.7,46.5,30.4,1.5,17.8,0.0,0.0,0.0,1.3,0.0,98.8,42098,20030,13079,0,12,18,567,635,7690,0,42582,227,67.3,30.4,0.5,0.0,0.0,0.0,1.3,29019,13079,0,12,6,549
E14000959,SPELTHORNE,43099,42889,97.4,85.4,84.0,23.4,23.4,0.0,0.0,0.6,2.2,0.0,97.9,41958,36792,36186,0,11,254,931,10103,10103,1,42175,0,13.4,84.0,0.0,0.0,0.0,0.6,1.6,5772,36186,0,11,243,677
E14000960,ST ALBANS,43800,43705,97.7,86.6,84.1,40.6,40.6,0.0,0.0,0.1,2.1,0.0,99.1,42802,37935,36856,1,3,26,903,17763,17763,3,43414,0,13.6,84.1,0.0,0.0,0.0,0.1,2.0,5946,36856,1,2,23,877
E14000961,ST AUSTELL AND NEWQUAY,49645,49215,90.3,37.6,30.8,26.7,26.7,0.1,0.7,1.4,8.8,0.5,93.8,44825,18673,15305,50,330,685,4390,13280,13280,238,46552,1393,59.5,30.8,2.8,0.1,0.6,0.7,7.5,29520,15305,50,280,355,3705
E14000962,ST HELENS NORTH,45335,45302,98.2,84.5,79.9,2.9,75.7,0.1,0.3,0.5,1.7,0.0,99.8,44537,38323,36244,58,145,236,765,1303,34332,4,45224,7475,18.3,79.9,16.5,0.1,0.2,0.2,1.2,8293,36244,58,87,91,529
E14000963,ST HELENS SOUTH AND WHISTON,48765,48683,97.9,85.6,82.5,9.6,82.4,0.0,0.3,0.5,2.0,0.0,98.6,47721,41733,40250,19,150,261,962,4679,40166,2,48104,2267,15.3,82.5,4.6,0.0,0.3,0.2,1.4,7471,40250,19,131,111,701
E14000964,ST IVES,43266,43022,88.8,34.9,34.9,34.9,34.9,0.2,0.6,1.6,10.7,0.7,93.7,38414,15113,15113,97,274,691,4608,15113,15113,305,40536,239,53.9,34.9,0.6,0.2,0.4,1.0,9.1,23301,15113,97,177,417,3917
E14000965,STAFFORD,44771,44707,96.0,70.7,70.5,6.4,10.5,0.2,0.5,1.1,3.9,0.1,98.5,42963,31635,31585,69,219,479,1744,2887,4695,48,44120,319,25.4,70.5,0.7,0.2,0.3,0.6,2.8,11378,31585,69,150,260,1265
E14000966,STAFFORDSHIRE MOORLANDS,35194,35054,90.5,36.4,34.9,3.3,3.3,0.8,1.9,3.6,9.1,1.3,97.4,31838,12794,12296,265,653,1280,3216,1153,1153,444,34263,0,55.5,34.9,0.0,0.8,1.1,1.8,5.5,19542,12296,265,388,627,1936
E14000967,STALYBRIDGE AND HYDE,44129,43887,96.0,24.3,24.2,15.2,15.2,0.0,0.0,0.1,3.5,0.0,99.3,42360,10710,10700,2,17,54,1527,6698,6698,3,43802,0,71.7,24.2,0.0,0.0,0.0,0.1,3.3,31660,10700,2,15,37,1473
E14000968,STEVENAGE,42360,42295,99.1,86.7,86.7,5.4,5.4,0.0,0.0,0.1,0.8,0.0,99.5,41969,36736,36723,0,6,23,326,2278,2278,6,42169,0,12.4,86.7,0.0,0.0,0.0,0.0,0.7,5246,36723,0,6,17,303
E14000969,STOCKPORT,41098,40712,98.5,87.1,87.1,3.2,41.1,0.0,0.0,0.0,0.6,0.0,98.6,40480,35813,35788,1,2,5,232,1329,16908,0,40509,1935,11.4,87.1,4.7,0.0,0.0,0.0,0.6,4692,35788,1,1,3,227
E14000970,STOCKTON NORTH,42317,42248,97.1,91.2,90.4,4.0,4.0,0.1,0.5,0.9,2.7,0.0,98.2,41096,38573,38262,50,215,376,1152,1700,1700,19,41574,3975,6.7,90.4,9.4,0.1,0.4,0.4,1.8,2834,38262,50,165,161,776
E14000971,STOCKTON SOUTH,45714,45696,97.5,87.1,86.4,7.7,7.7,0.0,0.5,0.9,2.5,0.0,98.0,44572,39835,39519,22,215,426,1124,3526,3526,14,44779,15030,11.1,86.4,32.9,0.0,0.4,0.5,1.5,5053,39519,22,193,211,698
E14000972,STOKE-ON-TRENT CENTRAL,39390,39306,98.3,87.9,87.9,2.2,2.2,0.0,0.0,0.1,1.5,0.0,98.5,38720,34628,34627,0,2,33,586,873,873,1,38794,0,10.4,87.9,0.0,0.0,0.0,0.1,1.4,4093,34627,0,2,31,553
E14000973,STOKE-ON-TRENT NORTH,44498,44450,99.0,89.0,87.6,18.3,18.3,0.0,0.0,0.1,0.9,0.0,99.5,44065,39609,38988,0,12,35,385,8156,8156,3,44294,0,11.4,87.6,0.0,0.0,0.0,0.1,0.8,5077,38988,0,12,23,350
E14000974,STOKE-ON-TRENT SOUTH,40296,40256,98.3,70.2,70.2,11.8,11.8,0.0,0.0,0.1,1.6,0.0,99.7,39592,28279,28279,0,8,51,664,4743,4743,0,40184,0,28.1,70.2,0.0,0.0,0.0,0.1,1.5,11313,28279,0,8,43,613
E14000975,STONE,39188,39004,91.2,28.6,28.6,22.9,22.9,0.4,1.5,2.7,8.4,0.6,98.3,35726,11218,11218,140,573,1071,3278,8981,8981,248,38508,1568,62.5,28.6,4.0,0.4,1.1,1.3,5.6,24508,11218,140,433,498,2207
E14000976,STOURBRIDGE,39436,39337,99.1,94.0,93.2,4.4,92.5,0.0,0.0,0.0,0.6,0.0,99.7,39091,37069,36761,0,4,4,246,1734,36480,0,39332,168,5.9,93.2,0.4,0.0,0.0,0.0,0.6,2330,36761,0,4,0,242
E14000977,STRATFORD-ON-AVON,44109,43868,95.5,48.4,45.4,20.7,42.6,0.2,0.7,1.3,4.0,0.4,98.8,42116,21327,20021,96,316,588,1752,9120,18775,191,43569,459,50.1,45.4,1.0,0.2,0.5,0.6,2.6,22095,20021,96,220,272,1164
E14000978,STREATHAM,51791,51564,95.5,71.2,63.0,17.1,56.3,0.0,0.0,0.0,4.1,0.0,95.8,49441,36884,32638,0,0,1,2123,8875,29180,1,49593,0,32.4,63.0,0.0,0.0,0.0,0.0,4.1,16803,32638,0,0,1,2122
E14000979,STRETFORD AND URMSTON,43986,43848,99.0,68.3,66.8,4.0,66.2,0.0,0.0,0.0,0.7,0.0,99.3,43535,30054,29367,2,2,11,313,1749,29126,0,43700,2,32.2,66.8,0.0,0.0,0.0,0.0,0.7,14168,29367,2,0,9,302
E14000980,STROUD,47858,47738,92.2,18.7,18.7,14.4,14.4,0.3,0.9,1.9,7.5,0.2,95.4,44133,8941,8929,155,429,931,3605,6879,6879,91,45678,709,73.6,18.7,1.5,0.3,0.6,1.0,5.6,35204,8929,155,274,502,2674
E14000981,SUFFOLK COASTAL,51896,51696,95.0,26.1,26.0,13.0,13.0,0.1,0.5,1.1,4.7,0.5,98.9,49277,13535,13508,69,263,578,2419,6748,6748,267,51323,2936,68.9,26.0,5.7,0.1,0.4,0.6,3.5,35769,13508,69,194,315,1841
E14000982,SUNDERLAND CENTRAL,47638,47546,98.2,65.1,60.5,9.9,9.9,0.0,0.0,0.0,1.6,0.0,98.6,46800,31004,28824,1,1,18,746,4727,4727,0,46992,0,37.7,60.5,0.0,0.0,0.0,0.0,1.5,17976,28824,1,0,17,728
E14000983,SURREY HEATH,45441,45371,98.5,71.9,71.5,8.2,8.2,0.0,0.0,0.1,1.3,0.0,99.8,44774,32674,32469,0,14,28,597,3706,3706,5,45356,0,27.1,71.5,0.0,0.0,0.0,0.0,1.3,12305,32469,0,14,14,569
E14000984,SUTTON AND CHEAM,42935,42848,98.5,87.6,85.8,8.4,84.4,0.0,0.0,0.0,1.3,0.0,98.5,42274,37613,36851,0,3,3,574,3589,36236,0,42292,0,12.6,85.8,0.0,0.0,0.0,0.0,1.3,5423,36851,0,3,0,571
E14000985,SUTTON COLDFIELD,41688,41666,98.5,86.6,85.9,39.1,85.6,0.0,0.1,0.3,1.4,0.1,98.7,41074,36087,35810,3,32,141,592,16297,35694,44,41137,0,12.6,85.9,0.0,0.0,0.1,0.3,1.1,5264,35810,3,29,109,451
E14000986,TAMWORTH,41539,41448,97.8,79.1,76.1,7.0,74.3,0.2,0.3,0.6,2.0,0.0,99.6,40636,32853,31625,89,126,261,812,2905,30873,17,41382,0,21.7,76.1,0.0,0.2,0.1,0.3,1.3,9011,31625,89,37,135,551
E14000987,TATTON,39813,39710,93.6,54.5,48.1,8.4,44.5,0.3,0.7,1.5,6.2,0.3,98.7,37256,21709,19166,102,288,581,2454,3356,17719,118,39301,1542,45.4,48.1,3.9,0.3,0.5,0.7,4.7,18090,19166,102,186,293,1873
E14000988,TAUNTON DEANE,54570,54393,89.8,33.6,21.1,12.0,12.0,0.5,2.0,4.0,9.8,1.3,95.8,49023,18328,11501,288,1072,2185,5370,6527,6527,730,52255,18,68.8,21.1,0.0,0.5,1.4,2.0,5.8,37522,11501,288,784,1113,3185
E14000989,TELFORD,43140,43033,99.1,87.1,85.2,11.0,11.0,0.0,0.0,0.1,0.6,0.0,99.5,42771,37566,36745,0,2,43,262,4761,4761,3,42913,18520,14.0,85.2,42.9,0.0,0.0,0.1,0.5,6026,36745,0,2,41,219
E14000990,TEWKESBURY,51603,50817,92.9,63.3,60.4,21.2,21.2,0.2,0.8,1.5,5.5,0.6,94.3,47956,32645,31189,98,416,781,2861,10919,10919,298,48636,1,32.5,60.4,0.0,0.2,0.6,0.7,4.0,16767,31189,98,318,365,2080
E14000991,THE COTSWOLDS,49111,48982,94.0,40.3,40.0,39.9,39.9,0.2,0.7,1.5,5.7,0.7,96.2,46181,19774,19639,76,335,729,2801,19598,19598,327,47243,243,54.0,40.0,0.5,0.2,0.5,0.8,4.2,26542,19639,76,259,394,2072
E14000992,THE WREKIN,42154,42072,96.1,76.7,74.2,6.5,6.5,0.2,0.6,1.3,3.7,0.2,99.4,40512,32342,31271,88,235,551,1560,2759,2759,78,41912,15467,21.9,74.2,36.7,0.2,0.3,0.7,2.4,9241,31271,88,147,316,1009
E14000993,THIRSK AND MALTON,49560,48872,88.2,9.3,9.3,9.3,9.3,1.9,3.7,5.7,10.4,1.7,95.8,43730,4599,4599,948,1853,2835,5142,4597,4597,835,47499,16673,79.0,9.3,33.6,1.9,1.8,2.0,4.7,39131,4599,948,905,982,2307
E14000994,THORNBURY AND YATE,38285,38143,97.5,72.0,71.9,17.3,17.3,0.1,0.4,0.8,2.1,0.2,99.3,37342,27582,27516,50,145,303,801,6636,6636,68,38022,0,25.7,71.9,0.0,0.1,0.2,0.4,1.3,9826,27516,50,95,158,498
E14000995,THURROCK,51075,51013,97.0,84.9,83.3,17.3,17.3,0.0,0.1,1.2,2.9,0.0,97.5,49550,43386,42541,6,54,630,1463,8813,8813,3,49805,0,13.7,83.3,0.0,0.0,0.1,1.1,1.6,7009,42541,6,48,576,833
E14000996,TIVERTON AND HONITON,47616,47471,83.2,14.0,14.0,14.0,14.0,0.9,3.5,6.9,16.5,2.3,93.9,39629,6668,6668,425,1655,3272,7842,6668,6668,1080,44693,527,69.2,14.0,1.1,0.9,2.6,3.4,9.6,32961,6668,425,1230,1617,4570
E14000997,TONBRIDGE AND MALLING,44277,44178,93.4,61.1,60.6,20.9,20.9,0.2,0.6,1.1,6.4,0.4,98.9,41349,27038,26841,105,255,496,2829,9234,9234,166,43796,1456,32.8,60.6,3.3,0.2,0.3,0.5,5.3,14508,26841,105,150,241,2333
E14000998,TOOTING,45555,45390,98.2,84.9,81.3,48.4,78.0,0.0,0.0,0.0,1.5,0.0,98.2,44714,38690,37049,0,0,6,676,22037,35538,0,44716,2,16.8,81.3,0.0,0.0,0.0,0.0,1.5,7665,37049,0,0,6,670
E14000999,TORBAY,54238,54034,95.7,84.0,80.6,39.8,39.8,0.0,0.0,0.1,3.9,0.0,97.1,51901,45542,43741,0,9,74,2133,21589,21589,11,52647,0,15.0,80.6,0.0,0.0,0.0,0.1,3.8,8160,43741,0,9,65,2059
E14001000,TORRIDGE AND WEST DEVON,46963,46698,81.4,12.2,12.2,12.2,12.2,2.0,6.0,10.5,18.0,1.8,93.9,38239,5748,5748,923,2837,4952,8459,5748,5748,855,44110,25662,69.2,12.2,54.6,2.0,4.1,4.5,7.5,32491,5748,923,1914,2115,3507
E14001001,TOTNES,45051,44809,86.5,31.4,30.7,25.5,25.5,0.6,2.0,4.6,12.9,1.5,95.8,38976,14155,13843,290,891,2066,5833,11493,11493,685,43172,5606,55.8,30.7,12.4,0.6,1.3,2.6,8.4,25133,13843,290,601,1175,3767
E14001002,TOTTENHAM,51244,51202,99.1,91.4,90.7,7.2,90.1,0.0,0.0,0.2,0.8,0.0,99.1,50788,46830,46483,0,10,94,414,3670,46166,0,50794,0,8.4,90.7,0.0,0.0,0.0,0.2,0.6,4305,46483,0,10,84,320
E14001003,TRURO AND FALMOUTH,45560,45288,87.6,33.7,33.4,33.2,33.2,0.1,0.4,1.5,11.8,0.4,91.9,39927,15335,15235,50,197,671,5361,15148,15148,200,41853,660,54.2,33.4,1.4,0.1,0.3,1.0,10.3,24692,15235,50,147,474,4690
E14001004,TUNBRIDGE WELLS,45634,45432,94.2,63.1,59.5,26.6,26.6,0.1,0.7,1.5,5.3,0.7,98.7,42992,28806,27148,38,342,704,2440,12148,12148,302,45024,0,34.7,59.5,0.0,0.1,0.7,0.8,3.8,15844,27148,38,304,362,1736
E14001005,TWICKENHAM,49438,49303,98.9,89.7,89.1,33.7,88.6,0.0,0.0,0.1,0.8,0.0,99.0,48910,44352,44038,0,1,69,393,16660,43817,11,48958,0,9.9,89.1,0.0,0.0,0.0,0.1,0.7,4872,44038,0,1,68,324
E14001006,TYNEMOUTH,46800,46702,99.3,90.4,88.5,33.7,33.7,0.0,0.1,0.2,0.5,0.1,99.4,46456,42318,41407,10,40,76,246,15775,15775,31,46513,0,10.8,88.5,0.0,0.0,0.1,0.1,0.4,5049,41407,10,30,36,170
E14001007,UXBRIDGE AND SOUTH RUISLIP,42855,42381,95.6,85.3,85.1,17.0,85.0,0.0,0.3,0.6,3.3,0.0,95.7,40988,36566,36483,17,113,264,1393,7277,36434,0,41023,0,10.5,85.1,0.0,0.0,0.2,0.4,2.6,4505,36483,17,96,151,1129
E14001008,VAUXHALL,59542,59215,97.6,82.1,78.9,23.1,77.8,0.0,0.0,0.0,1.9,0.0,97.6,58093,48875,46971,0,0,2,1122,13768,46344,2,58114,0,18.7,78.9,0.0,0.0,0.0,0.0,1.9,11122,46971,0,0,2,1120
E14001009,WAKEFIELD,41348,41305,97.8,75.1,74.9,20.0,20.0,0.0,0.0,0.2,2.1,0.0,98.8,40429,31048,30964,0,1,100,876,8273,8273,2,40848,0,22.9,74.9,0.0,0.0,0.0,0.2,1.9,9465,30964,0,1,99,776
E14001010,WALLASEY,41856,41824,99.5,91.5,91.3,84.4,84.4,0.0,0.0,0.0,0.5,0.0,99.7,41630,38304,38234,0,1,2,194,35339,35339,9,41740,0,8.1,91.3,0.0,0.0,0.0,0.0,0.5,3396,38234,0,1,1,192
E14001011,WALSALL NORTH,39858,39815,98.7,88.5,86.9,7.4,85.8,0.0,0.0,0.9,1.2,0.1,98.8,39326,35281,34628,0,0,345,489,2932,34206,30,39383,0,11.8,86.9,0.0,0.0,0.0,0.9,0.4,4698,34628,0,0,345,144
E14001012,WALSALL SOUTH,39050,38943,98.8,70.7,70.4,11.4,66.6,0.0,0.0,0.0,0.9,0.0,99.5,38583,27606,27480,1,7,17,360,4465,25993,4,38858,0,28.4,70.4,0.0,0.0,0.0,0.0,0.9,11103,27480,1,6,10,343
E14001013,WALTHAMSTOW,45782,45433,96.0,90.0,86.9,25.3,85.5,0.0,0.0,0.4,3.3,0.0,96.0,43932,41216,39780,0,0,169,1501,11605,39132,20,43959,0,9.1,86.9,0.0,0.0,0.0,0.4,2.9,4152,39780,0,0,169,1332
E14001014,WANSBECK,38962,38923,96.8,10.6,6.0,3.8,3.8,0.0,0.1,0.2,3.1,0.0,99.8,37731,4114,2357,8,32,60,1192,1472,1472,8,38887,0,90.8,6.0,0.0,0.0,0.1,0.1,2.9,35374,2357,8,24,28,1132
E14001015,WANTAGE,55313,55038,96.6,60.4,58.0,23.6,23.6,0.1,0.3,0.6,2.9,0.1,99.2,53415,33388,32097,50,142,322,1623,13045,13045,59,54871,0,38.5,58.0,0.0,0.1,0.2,0.3,2.4,21318,32097,50,92,180,1301
E14001016,WARLEY,38754,38698,99.7,89.6,88.5,38.0,87.9,0.0,0.0,0.0,0.1,0.0,99.8,38653,34705,34280,3,3,7,45,14722,34047,0,38668,1,11.3,88.5,0.0,0.0,0.0,0.0,0.1,4373,34280,3,0,4,38
E14001017,WARRINGTON NORTH,42961,42902,98.8,82.9,80.1,8.8,78.7,0.0,0.1,0.1,1.1,0.0,99.8,42424,35609,34407,18,30,50,478,3766,33798,6,42884,0,18.7,80.1,0.0,0.0,0.0,0.0,1.0,8017,34407,18,12,20,428
E14001018,WARRINGTON SOUTH,51155,50348,96.2,70.6,66.9,5.3,64.5,0.0,0.1,0.1,2.2,0.0,98.0,49220,36134,34215,5,42,62,1128,2718,32983,15,50143,8,29.3,66.9,0.0,0.0,0.1,0.0,2.1,15005,34215,5,37,20,1066
E14001019,WARWICK AND LEAMINGTON,47392,47308,99.2,83.0,76.7,10.2,72.4,0.0,0.2,0.3,0.6,0.0,99.5,47029,39313,36333,2,86,138,279,4812,34333,10,47158,0,22.6,76.7,0.0,0.0,0.2,0.1,0.3,10696,36333,2,84,52,141
E14001020,WASHINGTON AND SUNDERLAND WEST,40033,39994,98.4,80.6,77.1,3.6,3.6,0.0,0.1,0.3,1.5,0.0,99.4,39404,32268,30849,13,25,119,590,1425,1425,5,39785,0,21.4,77.1,0.0,0.0,0.0,0.2,1.2,8555,30849,13,12,94,471
E14001021,WATFORD,50904,50646,98.9,92.1,88.8,6.6,6.6,0.0,0.0,0.1,0.5,0.0,99.2,50368,46879,45181,0,7,49,278,3376,3376,0,50497,0,10.2,88.8,0.0,0.0,0.0,0.1,0.4,5187,45181,0,7,42,229
E14001022,WAVENEY,48120,47998,96.6,16.6,16.6,16.6,16.6,0.1,0.2,0.4,3.1,0.2,99.1,46494,7980,7979,37,98,183,1504,7980,7980,94,47681,3,80.0,16.6,0.0,0.1,0.1,0.2,2.7,38515,7979,37,61,85,1321
E14001023,WEALDEN,46125,46011,95.0,51.7,51.4,51.3,51.3,0.2,0.6,1.2,4.8,0.6,99.2,43800,23838,23719,84,285,542,2211,23681,23681,283,45746,0,43.5,51.4,0.0,0.2,0.4,0.6,3.6,20081,23719,84,201,257,1669
E14001024,WEAVER VALE,42035,41650,95.7,37.9,31.8,9.8,9.8,0.1,0.4,0.6,3.4,0.1,98.8,40240,15940,13367,62,148,265,1410,4108,4109,61,41544,0,63.9,31.8,0.0,0.1,0.2,0.3,2.7,26873,13367,62,86,117,1145
E14001025,WELLINGBOROUGH,49997,49931,98.7,72.1,71.9,9.7,9.7,0.0,0.2,0.3,1.1,0.0,99.5,49370,36024,35968,6,76,157,561,4838,4838,7,49744,4759,26.8,71.9,9.5,0.0,0.1,0.2,0.8,13402,35968,6,70,81,404
E14001026,WELLS,48948,48802,93.8,41.2,32.8,27.1,27.1,0.2,0.8,1.6,5.9,0.4,97.6,45914,20180,16038,117,381,783,2888,13277,13277,177,47757,5798,61.0,32.8,11.8,0.2,0.5,0.8,4.3,29876,16038,117,264,402,2105
E14001027,WELWYN HATFIELD,46231,46181,97.7,77.7,75.7,11.5,11.5,0.0,0.0,0.2,2.2,0.0,99.5,45171,35904,35010,5,19,88,1010,5294,5294,1,45987,0,22.0,75.7,0.0,0.0,0.0,0.1,2.0,10161,35010,5,14,69,922
E14001028,WENTWORTH AND DEARNE,45470,45377,99.2,53.8,50.2,14.8,14.8,0.0,0.0,0.1,0.6,0.0,99.8,45095,24457,22811,1,17,45,282,6717,6717,16,45364,0,49.0,50.2,0.0,0.0,0.0,0.1,0.5,22284,22811,1,16,28,237
E14001029,WEST BROMWICH EAST,37812,37790,99.4,85.5,84.2,17.2,82.9,0.0,0.0,0.3,0.5,0.0,99.4,37586,32311,31839,0,0,129,204,6489,31352,0,37597,0,15.2,84.2,0.0,0.0,0.0,0.3,0.2,5747,31839,0,0,129,75
E14001030,WEST BROMWICH WEST,39392,39340,99.7,82.1,81.6,1.8,50.1,0.0,0.0,0.1,0.2,0.0,99.7,39271,32338,32148,0,6,41,69,722,19730,0,39284,3,18.1,81.6,0.0,0.0,0.0,0.1,0.1,7123,32148,0,6,35,28
E14001031,WEST DORSET,48740,48641,93.0,12.8,10.8,9.3,9.3,0.2,1.0,2.0,6.8,0.6,97.9,45327,6249,5255,105,477,953,3314,4514,4514,293,47716,748,82.2,10.8,1.5,0.2,0.8,1.0,4.8,40072,5255,105,372,476,2361
E14001032,WEST HAM,67705,67489,99.1,93.2,89.8,49.4,86.3,0.0,0.0,0.1,0.6,0.0,99.1,67069,63093,60812,1,5,83,420,33445,58436,0,67073,0,9.2,89.8,0.0,0.0,0.0,0.1,0.5,6257,60812,1,4,78,337
E14001033,WEST LANCASHIRE,42139,42054,95.5,51.8,41.7,35.2,35.3,0.2,0.8,1.2,4.3,0.1,98.9,40250,21817,17592,94,328,504,1804,14826,14855,27,41692,6711,53.8,41.7,15.9,0.2,0.6,0.4,3.1,22658,17592,94,234,176,1300
E14001034,WEST SUFFOLK,52746,52668,96.0,33.0,29.2,13.2,13.2,0.2,0.4,0.7,3.9,0.4,99.3,50626,17417,15401,92,223,363,2042,6972,6972,186,52392,336,66.8,29.2,0.6,0.2,0.2,0.3,3.2,35225,15401,92,131,140,1679
E14001035,WEST WORCESTERSHIRE,44724,44490,91.4,22.7,16.9,13.5,13.5,0.4,1.5,2.9,8.1,0.7,97.9,40884,10130,7577,179,679,1283,3606,6057,6057,333,43797,2134,74.5,16.9,4.8,0.4,1.1,1.4,5.2,33307,7577,179,500,604,2323
E14001036,WESTMINSTER NORTH,60280,60058,97.8,66.9,65.5,60.8,62.2,0.0,0.0,0.0,1.9,0.0,97.8,58936,40315,39455,0,0,1,1122,36636,37502,0,58942,0,32.3,65.5,0.0,0.0,0.0,0.0,1.9,19481,39455,0,0,1,1121
E14001037,WESTMORLAND AND LONSDALE,43338,43233,94.4,17.1,15.1,13.8,13.8,0.3,0.9,1.5,5.4,0.7,98.5,40896,7428,6538,151,373,643,2337,5967,5967,302,42708,17097,79.3,15.1,39.5,0.3,0.5,0.6,3.9,34358,6538,151,222,270,1694
E14001038,WESTON-SUPER-MARE,51703,51131,93.2,53.9,46.0,39.4,39.4,0.1,0.2,0.6,5.7,0.0,96.7,48175,27857,23774,57,113,325,2956,20374,20374,22,50007,0,47.2,46.0,0.0,0.1,0.1,0.4,5.1,24401,23774,57,56,212,2631
E14001039,WIGAN,47298,47271,98.4,90.4,88.9,4.2,4.2,0.0,0.1,0.3,1.6,0.0,99.5,46532,42769,42054,10,53,155,739,1986,1986,10,47059,6392,9.5,88.9,13.5,0.0,0.1,0.2,1.2,4478,42054,10,43,102,584
E14001040,WIMBLEDON,42806,42781,99.1,89.9,89.5,47.3,89.5,0.0,0.0,0.1,0.8,0.0,99.2,42439,38484,38305,0,8,29,342,20257,38305,0,42459,0,9.7,89.5,0.0,0.0,0.0,0.0,0.7,4134,38305,0,8,21,313
E14001041,WINCHESTER,42421,42352,95.8,58.0,57.8,3.6,4.5,0.2,0.5,1.0,4.0,0.2,99.0,40646,24591,24529,89,204,405,1706,1545,1913,73,41997,0,38.0,57.8,0.0,0.2,0.3,0.5,3.1,16117,24529,89,115,201,1301
E14001042,WINDSOR,46383,46282,94.5,59.1,56.0,9.8,20.6,0.0,0.1,0.6,5.2,0.1,97.5,43852,27418,25996,22,69,261,2430,4531,9550,31,45219,0,38.5,56.0,0.0,0.0,0.1,0.4,4.7,17856,25996,22,47,192,2169
E14001043,WIRRAL SOUTH,32953,32939,97.2,65.7,65.7,13.3,13.3,0.1,0.1,0.3,2.8,0.0,99.8,32027,21664,21664,20,35,101,912,4391,4391,0,32871,0,31.4,65.7,0.0,0.1,0.0,0.2,2.5,10363,21664,20,15,66,811
E14001044,WIRRAL WEST,31761,31731,96.0,38.3,38.3,26.6,26.6,0.0,0.1,0.2,3.9,0.0,99.0,30501,12160,12160,3,33,67,1230,8456,8456,11,31434,0,57.7,38.3,0.0,0.0,0.1,0.1,3.7,18341,12160,3,30,34,1163
E14001045,WITHAM,40483,40369,94.4,17.7,17.7,11.5,11.5,0.3,1.1,1.9,5.3,0.4,97.4,38236,7185,7185,118,441,763,2133,4659,4659,156,39417,3720,76.7,17.7,9.2,0.3,0.8,0.8,3.4,31051,7185,118,323,322,1370
E14001046,WITNEY,49637,49514,99.0,72.1,65.9,34.2,34.2,0.0,0.0,0.1,0.8,0.1,99.5,49139,35790,32706,9,20,41,375,16993,16993,37,49392,0,33.1,65.9,0.0,0.0,0.0,0.0,0.7,16433,32706,9,11,21,334
E14001047,WOKING,45479,45128,97.5,82.5,79.3,3.7,3.7,0.0,0.3,0.3,1.7,0.1,98.9,44355,37520,36081,1,139,149,773,1691,1691,26,44976,0,18.2,79.3,0.0,0.0,0.3,0.0,1.4,8274,36081,1,138,10,624
E14001048,WOKINGHAM,49538,48721,95.9,71.5,67.2,17.5,64.6,0.0,0.1,0.3,2.4,0.0,96.7,47522,35430,33276,8,32,147,1199,8681,31986,16,47926,0,28.8,67.2,0.0,0.0,0.0,0.2,2.1,14246,33276,8,24,115,1052
E14001049,WOLVERHAMPTON NORTH EAST,39289,39252,99.2,94.8,94.2,7.4,8.0,0.0,0.0,0.0,0.7,0.0,99.3,38984,37238,36996,0,0,0,268,2908,3126,0,39029,15,5.1,94.2,0.0,0.0,0.0,0.0,0.7,1988,36996,0,0,0,268
E14001050,WOLVERHAMPTON SOUTH EAST,39490,39401,99.2,92.7,91.7,2.6,2.6,0.0,0.0,0.1,0.5,0.0,99.7,39185,36614,36198,0,1,20,216,1023,1031,11,39354,444,7.6,91.7,1.1,0.0,0.0,0.0,0.5,2987,36198,0,1,19,196
E14001051,WOLVERHAMPTON SOUTH WEST,37718,37675,98.9,94.5,92.5,14.1,14.1,0.0,0.0,0.0,1.0,0.0,99.0,37291,35644,34884,0,0,11,384,5304,5306,0,37336,5035,6.4,92.5,13.3,0.0,0.0,0.0,1.0,2407,34884,0,0,11,373
E14001052,WORCESTER,45939,45764,98.9,21.6,10.2,2.7,2.7,0.0,0.0,0.0,0.7,0.0,99.4,45434,9939,4690,0,0,1,330,1259,1259,0,45647,22,88.7,10.2,0.0,0.0,0.0,0.0,0.7,40744,4690,0,0,1,329
E14001053,WORKINGTON,38065,38000,94.8,2.9,2.9,2.9,2.9,0.8,1.4,2.0,5.1,0.6,99.3,36067,1121,1121,302,515,761,1933,1121,1121,225,37808,0,91.8,2.9,0.0,0.8,0.6,0.6,3.1,34946,1121,302,213,246,1172
E14001054,WORSLEY AND ECCLES SOUTH,47739,47716,98.7,95.3,95.3,75.3,95.3,0.0,0.2,0.5,1.3,0.0,98.9,47103,45501,45501,3,92,261,613,35926,45501,4,47199,0,3.4,95.3,0.0,0.0,0.2,0.4,0.7,1602,45501,3,89,169,352
E14001055,WORTHING WEST,47482,47443,99.0,76.6,71.3,43.4,43.4,0.0,0.0,0.0,1.0,0.0,99.8,46985,36378,33851,0,0,8,458,20624,20624,1,47405,0,27.7,71.3,0.0,0.0,0.0,0.0,0.9,13134,33851,0,0,8,450
E14001056,WYCOMBE,44954,44817,97.7,51.8,39.9,5.7,31.8,0.0,0.1,0.2,2.0,0.2,99.4,43898,23284,17945,16,60,96,919,2561,14296,69,44702,0,57.7,39.9,0.0,0.0,0.1,0.1,1.8,25953,17945,16,44,36,823
E14001057,WYRE AND PRESTON NORTH,43013,42877,95.2,42.9,41.7,19.3,19.3,0.1,0.2,0.7,4.5,0.1,98.9,40960,18463,17926,46,101,285,1917,8316,8316,26,42554,16805,53.6,41.7,39.1,0.1,0.1,0.4,3.8,23034,17926,46,55,184,1632
E14001058,WYRE FOREST,45431,45317,97.2,50.4,50.3,2.2,50.3,0.2,0.4,0.7,2.6,0.3,99.5,44155,22910,22837,89,172,332,1162,998,22837,127,45225,1602,46.9,50.3,3.5,0.2,0.2,0.4,1.8,21318,22837,89,83,160,830
E14001059,WYTHENSHAWE AND SALE EAST,47982,47913,98.3,92.4,91.7,36.7,90.6,0.0,0.2,0.7,1.5,0.0,98.9,47188,44356,43994,4,86,338,725,17626,43451,0,47431,0,6.7,91.7,0.0,0.0,0.2,0.5,0.8,3194,43994,4,82,252,387
E14001060,YEOVIL,51762,51500,92.1,10.0,10.0,10.0,10.0,0.4,1.5,2.4,7.4,0.4,98.3,47657,5190,5190,208,759,1238,3843,5190,5190,198,50864,13,82.0,10.0,0.0,0.4,1.1,0.9,5.0,42467,5190,208,551,479,2605
E14001061,YORK CENTRAL,48465,48110,95.5,88.2,84.4,62.3,62.3,0.0,0.1,0.5,3.8,0.0,95.6,46260,42725,40883,0,29,236,1850,30178,30178,0,46353,710,11.1,84.4,1.5,0.0,0.1,0.4,3.3,5377,40883,0,29,207,1614
E14001062,YORK OUTER,41274,41197,95.6,68.5,66.3,59.5,59.5,0.1,0.3,0.8,4.2,0.1,98.9,39464,28284,27381,31,116,341,1733,24553,24553,25,40816,1860,29.3,66.3,4.5,0.1,0.2,0.5,3.4,12083,27381,31,85,225,1392
N06000001,BELFAST EAST,44272,44198,98.3,94.0,94.0,83.4,94.0,0.0,0.1,0.2,1.5,0.0,98.8,43530,41595,41595,7,56,91,668,36927,41595,19,43755,0,4.4,94.0,0.0,0.0,0.1,0.1,1.3,1935,41595,7,49,35,577
N06000002,BELFAST NORTH,48874,48809,99.0,95.9,95.9,80.7,95.9,0.0,0.0,0.4,0.9,0.0,99.2,48372,46856,46856,13,24,190,437,39449,46856,16,48473,0,3.1,95.9,0.0,0.0,0.0,0.3,0.5,1516,46856,13,11,166,247
N06000003,BELFAST SOUTH,51512,51429,99.3,93.4,93.3,75.0,93.3,0.0,0.0,0.0,0.5,0.1,99.4,51157,48088,48066,0,1,15,272,38620,48085,35,51187,0,6.0,93.3,0.0,0.0,0.0,0.0,0.5,3091,48066,0,1,14,257
N06000004,BELFAST WEST,38857,38809,99.6,93.8,93.8,78.7,93.8,0.0,0.0,0.1,0.3,0.1,99.8,38692,36466,36466,4,19,31,117,30585,36466,40,38776,0,5.7,93.8,0.0,0.0,0.0,0.0,0.2,2226,36466,4,15,12,86
N06000005,EAST ANTRIM,38988,38821,93.1,74.5,74.3,72.0,74.5,1.7,2.5,3.1,6.5,1.1,98.7,36282,29030,28952,658,971,1212,2539,28056,29030,419,38481,0,18.8,74.3,0.0,1.7,0.8,0.6,3.4,7330,28952,658,313,241,1327
N06000006,EAST LONDONDERRY,43695,42955,86.8,60.0,60.0,60.0,60.0,2.4,4.3,5.7,11.6,3.8,97.7,37908,26225,26210,1067,1861,2482,5047,26224,26225,1650,42688,0,26.8,60.0,0.0,2.4,1.8,1.4,5.9,11698,26210,1067,794,621,2565
N06000007,FERMANAGH AND SOUTH TYRONE,41707,41315,71.4,33.2,33.2,33.2,33.2,7.3,12.1,16.9,27.7,4.6,98.1,29769,13834,13834,3033,5048,7054,11546,13834,13834,1938,40914,18498,38.2,33.2,44.4,7.3,4.8,4.8,10.8,15935,13834,3033,2015,2006,4492
N06000008,FOYLE,40681,40647,97.8,92.2,92.2,73.6,92.2,0.3,0.5,0.7,2.2,0.1,99.4,39771,37499,37493,142,195,290,876,29931,37499,39,40453,0,5.6,92.2,0.0,0.3,0.1,0.2,1.4,2278,37493,142,53,95,586
N06000009,LAGAN VALLEY,42954,42821,92.4,74.8,74.7,63.9,74.8,0.5,1.7,2.6,7.3,1.0,99.4,39682,32128,32086,227,728,1118,3139,27459,32128,410,42692,0,17.7,74.7,0.0,0.5,1.2,0.9,4.7,7596,32086,227,501,390,2021
N06000010,MID ULSTER,35142,34889,80.8,51.4,51.4,51.4,51.4,3.0,6.1,9.2,18.5,5.6,97.8,28393,18057,18057,1071,2137,3228,6496,18057,18057,1961,34357,0,29.4,51.4,0.0,3.0,3.0,3.1,9.3,10336,18057,1071,1066,1091,3268
N06000011,NEWRY AND ARMAGH,42195,41858,83.4,58.5,58.1,58.5,58.5,2.8,5.2,7.5,15.8,3.9,98.3,35193,24687,24513,1182,2192,3163,6665,24687,24687,1650,41480,1512,25.3,58.1,3.6,2.8,2.4,2.3,8.3,10680,24513,1182,1010,971,3502
N06000012,NORTH ANTRIM,44590,44128,85.1,63.4,63.2,63.4,63.4,2.6,5.1,7.2,13.9,2.9,98.1,37931,28249,28187,1147,2291,3209,6197,28248,28249,1315,43729,0,21.9,63.2,0.0,2.6,2.6,2.1,6.7,9744,28187,1147,1144,918,2988
N06000013,NORTH DOWN,40177,40098,98.5,86.6,86.0,83.6,86.6,0.1,0.2,0.4,1.3,0.1,99.8,39564,34799,34555,42,96,152,534,33584,34799,43,40098,0,12.5,86.0,0.0,0.1,0.1,0.1,1.0,5009,34555,42,54,56,382
N06000014,SOUTH ANTRIM,39807,39604,88.9,74.7,74.3,68.1,74.6,2.3,4.2,5.4,10.6,1.8,99.0,35384,29728,29558,927,1675,2135,4220,27099,29692,722,39400,0,14.6,74.3,0.0,2.3,1.9,1.2,5.2,5826,29558,927,748,460,2085
N06000015,SOUTH DOWN,41280,40699,80.8,58.3,58.3,58.3,58.3,3.6,6.7,9.5,17.8,4.4,96.4,33364,24076,24074,1475,2761,3911,7335,24076,24076,1819,39780,827,22.5,58.3,2.0,3.6,3.1,2.8,8.3,9290,24074,1475,1286,1150,3424
N06000016,STRANGFORD,37647,37497,90.1,72.5,72.4,72.5,72.5,1.0,2.5,4.5,9.5,1.7,99.3,33930,27293,27264,380,944,1683,3567,27293,27293,640,37397,0,17.7,72.4,0.0,1.0,1.5,2.0,5.0,6666,27264,380,564,739,1884
N06000017,UPPER BANN,48989,48836,95.1,78.1,77.2,78.1,78.1,0.4,0.7,1.3,4.6,0.5,99.4,46593,38257,37809,180,364,615,2243,38257,38257,240,48715,0,17.9,77.2,0.0,0.4,0.4,0.5,3.3,8784,37809,180,184,251,1628
N06000018,WEST TYRONE,35525,35040,75.0,47.0,47.0,47.0,47.0,7.6,12.0,14.9,23.6,8.1,97.6,26658,16696,16682,2716,4257,5302,8382,16695,16696,2862,34663,2370,28.1,47.0,6.7,7.6,4.3,2.9,8.7,9976,16682,2716,1541,1045,3080
S14000001,ABERDEEN NORTH,54625,54210,95.7,66.7,57.0,49.3,49.3,0.0,0.0,0.2,3.5,0.0,96.9,52300,36430,31159,0,9,130,1910,26927,26927,12,52907,0,38.7,57.0,0.0,0.0,0.0,0.2,3.3,21141,31159,0,9,121,1780
S14000002,ABERDEEN SOUTH,50483,50163,95.9,73.2,70.6,68.6,68.6,0.0,0.2,0.3,3.5,0.1,97.3,48390,36949,35642,19,86,164,1773,34630,34630,70,49143,0,25.3,70.6,0.0,0.0,0.1,0.2,3.2,12748,35642,19,67,78,1609
S14000003,AIRDRIE AND SHOTTS,39608,39582,97.6,67.4,67.3,7.3,67.4,0.1,0.3,0.6,2.4,0.2,99.5,38651,26686,26649,20,113,239,931,2882,26682,98,39411,0,30.3,67.3,0.0,0.1,0.2,0.3,1.7,12002,26649,20,93,126,692
S14000004,ANGUS,43504,43008,86.4,9.2,9.2,9.2,9.2,1.5,4.2,7.5,12.4,2.9,94.5,37603,3995,3982,670,1809,3262,5405,3994,3994,1266,41105,0,77.3,9.2,0.0,1.5,2.6,3.3,4.9,33621,3982,670,1139,1453,2143
S14000005,ARGYLL AND BUTE,49110,47940,80.0,1.6,1.6,1.6,1.6,2.8,5.3,9.4,17.6,6.5,89.6,39297,809,809,1371,2587,4603,8643,808,809,3214,44015,0,78.4,1.6,0.0,2.8,2.5,4.1,8.2,38488,809,1371,1216,2016,4040
S14000006,"AYR, CARRICK AND CUMNOCK",45039,44899,94.7,44.2,42.5,18.1,18.1,0.5,1.4,2.4,5.0,1.2,98.2,42657,19902,19124,218,625,1083,2242,8160,8160,544,44216,0,52.3,42.5,0.0,0.5,0.9,1.0,2.6,23533,19124,218,407,458,1159
S14000007,BANFF AND BUCHAN,43649,43335,84.5,4.5,4.5,4.5,4.5,2.4,5.5,8.7,14.8,3.1,94.6,36890,1969,1969,1055,2383,3795,6445,1969,1969,1370,41288,0,80.0,4.5,0.0,2.4,3.0,3.2,6.1,34921,1969,1055,1328,1412,2650
S14000008,"BERWICKSHIRE, ROXBURGH AND SELKIRK",47897,47188,86.5,18.4,14.8,12.2,12.2,1.9,4.2,7.0,12.0,3.0,94.9,41453,8831,7082,905,2013,3329,5735,5864,5864,1457,45456,9144,71.8,14.8,19.1,1.9,2.3,2.7,5.0,34371,7082,905,1108,1316,2406
S14000009,"CAITHNESS, SUTHERLAND AND EASTER ROSS",27124,26697,77.5,1.5,1.5,1.5,1.5,2.7,6.1,10.3,21.0,4.9,92.5,21008,402,402,733,1668,2784,5689,402,402,1337,25092,2800,76.0,1.5,10.3,2.7,3.4,4.1,10.7,20606,402,733,935,1116,2905
S14000010,CENTRAL AYRSHIRE,42760,42746,95.8,73.2,73.2,11.5,11.5,0.2,0.6,1.6,4.2,0.4,99.1,40967,31291,31281,90,272,704,1779,4916,4916,184,42360,0,22.7,73.2,0.0,0.2,0.4,1.0,2.5,9686,31281,90,182,432,1075
S14000011,"COATBRIDGE, CHRYSTON AND BELLSHILL",44127,44053,99.0,86.6,84.7,23.1,84.7,0.1,0.2,0.3,0.8,0.1,99.4,43678,38214,37358,30,70,127,375,10186,37356,26,43846,0,14.3,84.7,0.0,0.1,0.1,0.1,0.6,6320,37358,30,40,57,248
S14000012,"CUMBERNAULD, KILSYTH AND KIRKINTILLOCH EAST",40989,40820,96.9,67.5,65.9,13.8,65.6,0.1,0.2,0.5,2.7,0.0,99.5,39705,27658,27006,22,94,211,1115,5653,26873,14,40773,0,31.0,65.9,0.0,0.1,0.2,0.3,2.2,12699,27006,22,72,117,904
S14000013,DUMFRIES AND GALLOWAY,48234,47723,87.6,6.4,6.4,6.4,6.4,1.5,3.4,5.7,11.3,2.9,96.6,42249,3076,3076,712,1616,2751,5474,3076,3076,1388,46608,0,81.2,6.4,0.0,1.5,1.9,2.4,5.6,39173,3076,712,904,1135,2723
S14000014,"DUMFRIESSHIRE, CLYDESDALE AND TWEEDDALE",41752,41351,85.2,15.8,15.8,15.8,15.8,1.8,4.2,7.3,13.8,3.6,95.5,35583,6594,6594,759,1772,3045,5768,6594,6594,1518,39883,0,69.4,15.8,0.0,1.8,2.4,3.0,6.5,28989,6594,759,1013,1273,2723
S14000015,DUNDEE EAST,42157,42096,97.1,81.0,79.6,2.2,2.2,0.2,0.5,1.1,2.8,0.1,99.2,40922,34152,33573,69,197,449,1174,926,926,58,41817,0,17.4,79.6,0.0,0.2,0.3,0.6,1.7,7349,33573,69,128,252,725
S14000016,DUNDEE WEST,46279,46235,98.2,88.0,85.7,15.4,15.4,0.1,0.2,0.5,1.7,0.1,99.2,45453,40706,39674,63,96,229,782,7117,7117,36,45918,0,12.5,85.7,0.0,0.1,0.1,0.3,1.2,5779,39674,63,33,133,553
S14000017,DUNFERMLINE AND WEST FIFE,48386,48311,97.6,57.9,56.8,57.3,57.3,0.2,0.7,0.9,2.3,0.2,99.6,47202,28033,27464,93,315,452,1109,27728,27728,77,48196,0,40.8,56.8,0.0,0.2,0.5,0.3,1.4,19738,27464,93,222,137,657
S14000018,EAST DUNBARTONSHIRE,36491,36266,97.5,85.9,85.0,22.2,84.2,0.0,0.1,0.2,1.9,0.0,98.3,35568,31350,31034,1,19,63,698,8106,30717,3,35887,0,12.4,85.0,0.0,0.0,0.0,0.1,1.7,4534,31034,1,18,44,635
S14000019,"EAST KILBRIDE, STRATHAVEN AND LESMAHAGOW",48082,47964,96.6,72.1,72.1,13.7,72.1,0.4,0.9,1.8,3.2,0.2,98.8,46445,34684,34682,214,445,876,1519,6595,34682,102,47490,0,24.5,72.1,0.0,0.4,0.5,0.9,1.3,11763,34682,214,231,431,643
S14000020,EAST LOTHIAN,47234,47056,93.3,33.1,33.0,33.1,33.1,0.4,1.4,2.2,6.3,0.3,97.7,44078,15658,15594,177,643,1056,2978,15655,15658,148,46151,17304,60.3,33.0,36.6,0.4,1.0,0.9,4.1,28484,15594,177,466,413,1922
S14000021,EAST RENFREWSHIRE,39702,39689,96.4,71.2,70.6,7.8,70.6,0.1,0.2,0.5,3.6,0.1,99.0,38263,28268,28039,29,87,201,1426,3082,28017,36,39305,0,25.8,70.6,0.0,0.1,0.1,0.3,3.1,10224,28039,29,58,114,1225
S14000022,EDINBURGH EAST,51869,51857,97.1,84.1,83.2,55.9,82.8,0.0,0.0,0.3,2.8,0.0,97.2,50385,43605,43135,1,24,174,1472,28991,42933,0,50426,0,14.0,83.2,0.0,0.0,0.0,0.3,2.5,7250,43135,1,23,150,1298
S14000023,EDINBURGH NORTH AND LEITH,61852,61817,98.7,87.0,84.7,29.2,82.9,0.0,0.1,0.1,1.3,0.0,98.7,61018,53800,52403,0,49,90,799,18073,51247,0,61044,1,13.9,84.7,0.0,0.0,0.1,0.1,1.1,8615,52403,0,49,41,709
S14000024,EDINBURGH SOUTH,40829,40527,98.4,91.6,90.4,52.0,89.7,0.0,0.0,0.1,0.9,0.0,98.5,40169,37418,36913,1,20,24,358,21213,36617,0,40226,0,8.0,90.4,0.0,0.0,0.0,0.0,0.8,3256,36913,1,19,4,334
S14000025,EDINBURGH SOUTH WEST,51332,51326,98.3,94.7,92.2,49.7,90.4,0.1,0.1,0.3,1.7,0.0,98.8,50479,48601,47322,59,74,141,847,25499,46379,9,50736,0,6.2,92.2,0.0,0.1,0.0,0.1,1.4,3157,47322,59,15,67,706
S14000026,EDINBURGH WEST,43819,43807,97.9,83.7,82.3,57.9,81.9,0.1,0.4,0.7,2.1,0.0,99.2,42900,36696,36075,33,163,299,907,25390,35892,12,43450,0,15.6,82.3,0.0,0.1,0.3,0.3,1.4,6825,36075,33,130,136,608
S14000027,NA H-EILEANAN AN IAR,15312,14052,77.1,4.6,4.6,4.6,4.6,2.5,3.8,5.1,14.7,6.7,88.5,11806,712,712,378,586,776,2246,712,712,1019,13556,0,72.5,4.6,0.0,2.5,1.4,1.2,9.6,11094,712,378,208,190,1470
S14000028,FALKIRK,49190,49153,97.6,87.5,87.4,10.9,87.3,0.1,0.3,0.5,2.3,0.1,99.2,48029,43025,42990,32,137,251,1124,5341,42933,63,48802,0,10.2,87.4,0.0,0.1,0.2,0.2,1.8,5039,42990,32,105,114,873
S14000029,GLASGOW CENTRAL,54049,53561,95.0,61.5,55.5,24.9,53.3,0.0,0.0,0.1,4.1,0.0,95.3,51338,33225,30009,0,3,53,2223,13475,28797,0,51532,0,39.5,55.5,0.0,0.0,0.0,0.1,4.0,21329,30009,0,3,50,2170
S14000030,GLASGOW EAST,45831,45736,99.0,78.5,75.5,41.5,72.8,0.0,0.0,0.4,0.7,0.0,99.1,45393,35971,34617,0,6,162,343,19026,33383,0,45422,0,23.5,75.5,0.0,0.0,0.0,0.3,0.4,10776,34617,0,6,156,181
S14000031,GLASGOW NORTH,40457,40167,98.7,82.5,75.0,9.6,69.3,0.0,0.1,0.2,0.6,0.0,98.8,39915,33395,30330,12,22,61,252,3896,28021,0,39991,0,23.7,75.0,0.0,0.0,0.0,0.1,0.5,9585,30330,12,10,39,191
S14000032,GLASGOW NORTH EAST,43337,43292,99.2,81.0,74.2,16.1,69.0,0.0,0.0,0.1,0.7,0.0,99.6,42982,35102,32174,0,4,40,310,6980,29887,0,43184,0,24.9,74.2,0.0,0.0,0.0,0.1,0.6,10808,32174,0,4,36,270
S14000033,GLASGOW NORTH WEST,44015,43988,99.7,82.9,75.8,3.8,69.5,0.0,0.0,0.0,0.3,0.0,99.8,43877,36477,33372,4,4,11,111,1679,30591,0,43938,0,23.9,75.8,0.0,0.0,0.0,0.0,0.2,10505,33372,4,0,7,100
S14000034,GLASGOW SOUTH,44462,44385,97.7,72.4,65.5,5.0,59.0,0.0,0.0,0.1,2.2,0.0,98.1,43423,32212,29114,1,11,61,962,2243,26228,0,43617,0,32.2,65.5,0.0,0.0,0.0,0.1,2.0,14309,29114,1,10,50,901
S14000035,GLASGOW SOUTH WEST,42369,42291,99.3,75.7,74.6,60.1,73.6,0.1,0.1,0.2,0.6,0.0,99.6,42053,32055,31600,23,62,67,238,25453,31200,0,42217,0,24.7,74.6,0.0,0.1,0.1,0.0,0.4,10453,31600,23,39,5,171
S14000036,GLENROTHES,43012,42946,97.3,75.1,75.0,6.0,6.0,0.1,0.2,0.7,2.5,0.0,99.3,41859,32296,32279,45,91,301,1087,2602,2602,8,42729,0,22.3,75.0,0.0,0.1,0.1,0.5,1.8,9580,32279,45,46,210,786
S14000037,GORDON,47326,47061,85.6,22.1,21.1,20.7,20.7,1.9,4.2,7.0,13.9,2.8,95.6,40502,10436,9997,879,1998,3321,6559,9779,9779,1324,45265,0,64.5,21.1,0.0,1.9,2.4,2.8,6.8,30505,9997,879,1119,1323,3238
S14000038,INVERCLYDE,39759,39744,97.3,74.9,74.8,10.7,10.7,0.1,0.3,0.6,2.7,0.2,98.9,38675,29772,29725,36,118,232,1069,4242,4242,67,39341,0,22.5,74.8,0.0,0.1,0.2,0.3,2.1,8950,29725,36,82,114,837
S14000039,"INVERNESS, NAIRN, BADENOCH AND STRATHSPEY",49014,48590,89.1,33.0,33.0,33.0,33.0,1.2,2.4,4.0,10.0,2.6,96.8,43685,16155,16155,583,1200,1942,4905,16155,16155,1296,47426,274,56.2,33.0,0.6,1.2,1.3,1.5,6.0,27530,16155,583,617,742,2963
S14000040,KILMARNOCK AND LOUDOUN,44877,44772,97.0,56.9,56.9,47.3,47.3,0.4,0.6,1.2,2.7,0.1,99.0,43551,25539,25537,182,288,536,1221,21245,21245,59,44427,0,40.1,56.9,0.0,0.4,0.2,0.6,1.5,18014,25537,182,106,248,685
S14000041,KIRKCALDY AND COWDENBEATH,48368,48338,98.2,67.0,66.8,24.7,24.7,0.1,0.2,0.3,1.8,0.1,99.4,47489,32389,32305,33,85,150,849,11954,11954,28,48076,0,31.4,66.8,0.0,0.1,0.1,0.1,1.4,15184,32305,33,52,65,699
S14000042,LANARK AND HAMILTON EAST,48603,48524,95.9,65.5,65.3,23.3,65.5,0.3,1.0,2.0,4.0,0.2,99.1,46600,31835,31759,167,494,969,1924,11339,31828,93,48178,0,30.5,65.3,0.0,0.3,0.7,1.0,2.0,14841,31759,167,327,475,955
S14000043,LINLITHGOW AND EAST FALKIRK,54236,54177,97.4,82.4,82.0,41.1,81.9,0.1,0.4,0.9,2.5,0.2,99.2,52815,44685,44460,56,195,488,1362,22296,44394,105,53798,3,15.4,82.0,0.0,0.1,0.3,0.5,1.6,8355,44460,56,139,293,874
S14000044,LIVINGSTON,49994,49949,98.5,81.5,79.9,30.2,78.7,0.2,0.3,0.4,1.4,0.1,99.6,49240,40740,39949,78,137,214,709,15106,39369,67,49791,0,18.6,79.9,0.0,0.2,0.1,0.2,1.0,9291,39949,78,59,77,495
S14000045,MIDLOTHIAN,40924,40574,94.0,49.5,49.1,49.4,49.5,0.6,1.2,2.3,5.1,0.5,97.9,38477,20246,20092,261,505,923,2097,20232,20246,214,40069,1961,44.9,49.1,4.8,0.6,0.6,1.0,2.9,18385,20092,261,244,418,1174
S14000046,MORAY,45773,45444,85.5,17.9,17.9,17.9,17.9,1.6,4.4,6.8,13.8,3.0,95.7,39150,8194,8194,743,2011,3111,6294,8194,8194,1394,43806,15908,67.6,17.9,34.8,1.6,2.8,2.4,7.0,30956,8194,743,1268,1100,3183
S14000047,MOTHERWELL AND WISHAW,44719,44699,99.2,88.6,88.4,7.8,88.2,0.0,0.0,0.1,0.7,0.0,99.6,44373,39639,39512,0,8,62,326,3496,39439,1,44546,0,10.9,88.4,0.0,0.0,0.0,0.1,0.6,4861,39512,0,8,54,264
S14000048,NORTH AYRSHIRE AND ARRAN,47691,47597,93.8,13.2,13.2,13.2,13.2,0.5,0.9,1.8,6.0,0.4,99.1,44726,6287,6282,230,445,841,2871,6287,6287,175,47264,0,80.6,13.2,0.0,0.5,0.5,0.8,4.3,38444,6282,230,215,396,2030
S14000049,NORTH EAST FIFE,40053,39407,90.5,18.3,17.6,12.2,12.2,0.6,1.9,3.5,7.9,0.6,96.6,36241,7332,7046,252,749,1407,3166,4885,4885,250,38697,0,72.9,17.6,0.0,0.6,1.2,1.6,4.4,29195,7046,252,497,658,1759
S14000050,OCHIL AND SOUTH PERTHSHIRE,49277,48991,89.0,20.4,14.9,12.6,12.6,1.3,2.9,4.8,10.4,1.3,97.3,43844,10038,7362,626,1441,2382,5147,6220,6220,645,47922,0,74.0,14.9,0.0,1.3,1.7,1.9,5.6,36482,7362,626,815,941,2765
S14000051,ORKNEY AND SHETLAND,22557,21727,68.1,1.6,1.6,1.6,1.6,3.5,8.3,18.2,28.2,7.5,80.4,15372,354,354,789,1865,4115,6355,354,354,1689,18133,0,66.6,1.6,0.0,3.5,4.8,10.0,9.9,15018,354,789,1076,2250,2240
S14000052,PAISLEY AND RENFREWSHIRE NORTH,44236,44213,97.1,84.2,84.1,27.5,58.9,0.1,0.2,0.3,2.8,0.1,98.9,42960,37261,37214,29,79,146,1253,12181,26039,41,43735,0,13.0,84.1,0.0,0.1,0.1,0.2,2.5,5746,37214,29,50,67,1107
S14000053,PAISLEY AND RENFREWSHIRE SOUTH,44700,44440,96.5,80.3,80.3,19.4,49.0,0.1,0.3,0.6,3.0,0.0,97.8,43115,35878,35876,59,151,265,1325,8675,21897,20,43695,0,16.2,80.3,0.0,0.1,0.2,0.3,2.4,7239,35876,59,92,114,1060
S14000054,PERTH AND NORTH PERTHSHIRE,48740,48391,87.8,50.2,49.0,4.2,4.2,1.1,3.0,5.5,11.5,2.1,95.8,42804,24447,23903,554,1475,2702,5587,2058,2058,1036,46671,1,38.8,49.0,0.0,1.1,1.9,2.5,5.9,18901,23903,554,921,1227,2885
S14000055,"ROSS, SKYE AND LOCHABER",29917,28706,76.2,4.4,4.4,4.4,4.4,3.5,6.2,10.7,19.8,5.5,90.2,22795,1319,1319,1051,1866,3188,5911,1319,1319,1657,26999,1936,71.8,4.4,6.5,3.5,2.7,4.4,9.1,21476,1319,1051,815,1322,2723
S14000056,RUTHERGLEN AND HAMILTON WEST,50542,50489,98.8,89.0,87.8,17.3,86.9,0.0,0.1,0.1,1.1,0.0,99.6,49930,44967,44381,18,40,47,559,8719,43904,1,50337,0,11.0,87.8,0.0,0.0,0.0,0.0,1.0,5549,44381,18,22,7,512
S14000057,STIRLING,42555,42077,90.1,54.7,52.3,51.5,51.5,1.3,2.7,4.3,8.8,2.3,96.5,38323,23275,22237,534,1128,1849,3754,21921,21929,998,41057,0,37.8,52.3,0.0,1.3,1.4,1.7,4.5,16086,22237,534,594,721,1905
S14000058,WEST ABERDEENSHIRE AND KINCARDINE,42372,41948,82.3,9.4,9.2,8.9,8.9,2.7,5.9,9.4,16.7,4.7,94.2,34890,3980,3890,1144,2493,3993,7058,3789,3789,2001,39900,0,73.2,9.2,0.0,2.7,3.2,3.5,7.2,31000,3890,1144,1349,1500,3065
S14000059,WEST DUNBARTONSHIRE,44489,44465,98.9,91.1,90.1,1.1,89.1,0.0,0.2,0.4,1.0,0.0,99.3,44001,40545,40098,17,68,176,464,499,39650,10,44164,0,8.8,90.1,0.0,0.0,0.1,0.2,0.6,3903,40098,17,51,108,288
W07000041,YNYS MÔN,34633,34312,89.6,17.1,17.1,17.1,17.1,0.8,2.0,3.5,9.5,1.5,95.5,31039,5906,5906,269,686,1216,3273,5906,5906,526,33077,8919,72.6,17.1,25.8,0.8,1.2,1.5,5.9,25133,5906,269,417,530,2057
W07000042,DELYN,32222,32146,93.1,23.8,18.5,15.5,15.5,0.4,1.3,3.0,6.6,0.5,97.2,30009,7658,5973,129,410,970,2137,5005,5005,169,31305,11595,74.6,18.5,36.0,0.4,0.9,1.7,3.6,24036,5973,129,281,560,1167
W07000043,ALYN AND DEESIDE,37342,37266,97.0,61.6,54.4,50.6,50.6,0.3,0.8,1.2,2.8,0.5,98.9,36233,23017,20315,110,298,444,1033,18881,18881,186,36917,16128,42.6,54.4,43.2,0.3,0.5,0.4,1.6,15918,20315,110,188,146,589
W07000044,WREXHAM,32549,32061,97.0,61.4,61.2,61.4,61.4,0.0,0.2,0.3,1.5,0.9,97.8,31571,19999,19922,13,52,108,490,19998,19998,286,31849,14290,35.8,61.2,43.9,0.0,0.1,0.2,1.2,11649,19922,13,39,56,382
W07000045,LLANELLI,38333,38229,95.6,29.0,29.0,29.0,29.0,0.4,1.0,1.9,4.1,0.2,98.6,36642,11111,11111,164,369,717,1587,11108,11108,91,37779,390,66.6,29.0,1.0,0.4,0.5,0.9,2.3,25531,11111,164,205,348,870
W07000046,GOWER,36630,36585,95.9,60.6,57.1,27.7,27.7,0.3,0.6,1.3,4.0,0.4,97.6,35124,22208,20925,104,238,474,1461,10163,10163,145,35768,12844,38.8,57.1,35.1,0.3,0.4,0.6,2.7,14199,20925,104,134,236,987
W07000047,SWANSEA WEST,37153,37131,99.6,93.2,90.7,34.7,34.7,0.0,0.0,0.0,0.3,0.0,99.8,37011,34636,33711,0,0,11,120,12876,12876,1,37080,17557,8.9,90.7,47.3,0.0,0.0,0.0,0.3,3300,33711,0,0,11,109
W07000048,SWANSEA EAST,38116,37853,98.6,90.1,88.4,29.2,29.2,0.0,0.0,0.0,0.7,0.0,98.9,37576,34326,33705,1,7,14,277,11122,11130,0,37710,25260,10.2,88.4,66.3,0.0,0.0,0.0,0.7,3871,33705,1,6,7,263
W07000049,ABERAVON,31245,31222,98.3,77.9,77.9,3.8,58.7,0.0,0.1,0.2,1.6,0.1,99.6,30711,24339,24335,14,31,64,511,1192,18341,18,31106,13880,20.4,77.9,44.4,0.0,0.1,0.1,1.4,6376,24335,14,17,33,447
W07000050,CARDIFF CENTRAL,36368,36308,98.4,85.1,82.9,54.4,81.0,0.0,0.0,0.1,1.4,0.0,98.5,35789,30948,30132,0,9,32,519,19796,29452,0,35812,24069,15.6,82.9,66.2,0.0,0.0,0.1,1.3,5657,30132,0,9,23,487
W07000051,CARDIFF NORTH,38285,38275,98.7,88.5,85.1,64.3,82.8,0.0,0.1,0.1,1.3,0.0,99.9,37793,33892,32583,12,22,39,482,24629,31701,2,38264,27401,13.6,85.1,71.6,0.0,0.0,0.0,1.2,5210,32583,12,10,17,443
W07000052,RHONDDA,33547,33480,99.2,1.5,1.5,1.5,1.5,0.0,0.0,0.0,0.6,0.0,99.8,33270,493,493,0,0,0,210,493,493,4,33480,1825,97.7,1.5,5.4,0.0,0.0,0.0,0.6,32777,493,0,0,0,210
W07000053,TORFAEN,37964,37903,97.7,49.8,40.2,6.5,6.5,0.1,0.3,0.5,2.1,0.1,99.0,37093,18905,15268,50,97,183,810,2484,2484,34,37603,24646,57.5,40.2,64.9,0.1,0.1,0.2,1.7,21825,15268,50,47,86,627
W07000054,MONMOUTH,38577,38394,86.5,31.6,24.1,19.4,19.4,1.5,3.4,6.1,13.0,2.9,95.8,33383,12208,9294,568,1307,2357,5011,7466,7466,1107,36938,3767,62.4,24.1,9.8,1.5,1.9,2.7,6.9,24089,9294,568,739,1050,2654
W07000055,NEWPORT EAST,35814,35742,97.9,73.2,67.7,7.6,7.6,0.1,0.3,0.7,1.9,0.1,98.4,35062,26214,24259,21,114,235,680,2735,2735,52,35247,9243,30.2,67.7,25.8,0.1,0.3,0.3,1.2,10803,24259,21,93,121,445
W07000056,NEWPORT WEST,40129,40082,98.3,69.7,65.4,10.1,10.1,0.0,0.1,0.2,1.6,0.0,99.2,39436,27977,26264,8,30,72,646,4064,4064,6,39820,14222,32.8,65.4,35.4,0.0,0.1,0.1,1.4,13172,26264,8,22,42,574
W07000057,ARFON,26916,26795,94.4,21.1,17.3,15.2,15.2,0.4,1.1,2.3,5.2,0.4,97.0,25396,5690,4651,111,303,621,1399,4103,4103,117,26113,11319,77.1,17.3,42.1,0.4,0.7,1.2,2.9,20745,4651,111,192,318,778
W07000058,ABERCONWY,27692,27650,94.9,11.2,11.2,11.2,11.2,0.5,1.4,2.4,4.9,1.0,97.7,26284,3091,3091,147,396,678,1366,3091,3091,275,27062,13553,83.8,11.2,48.9,0.5,0.9,1.0,2.5,23193,3091,147,249,282,688
W07000059,CLWYD WEST,34548,34439,90.0,9.5,9.5,9.5,9.5,1.3,3.0,5.5,9.7,2.1,95.3,31098,3284,3284,460,1052,1887,3341,3284,3284,717,32932,18849,80.5,9.5,54.6,1.3,1.7,2.4,4.2,27814,3284,460,592,835,1454
W07000060,VALE OF CLWYD,35387,35198,94.9,10.7,10.7,10.7,10.7,0.1,0.3,1.1,4.6,0.2,97.2,33569,3776,3776,34,102,389,1629,3776,3776,84,34409,13952,84.2,10.7,39.4,0.1,0.2,0.8,3.5,29793,3776,34,68,287,1240
W07000061,DWYFOR MEIRIONNYDD,33944,33655,83.9,18.1,18.1,18.1,18.1,1.9,4.8,7.8,15.3,3.2,91.6,28475,6150,6150,653,1641,2648,5180,6150,6150,1082,31105,4,65.8,18.1,0.0,1.9,2.9,3.0,7.5,22325,6150,653,988,1007,2532
W07000062,CLWYD SOUTH,32589,32455,92.7,19.7,18.7,17.8,17.8,0.8,2.1,3.7,6.9,1.3,96.8,30195,6417,6080,260,670,1210,2260,5805,5805,411,31553,12927,74.0,18.7,39.7,0.8,1.3,1.7,3.2,24115,6080,260,410,540,1050
W07000063,MONTGOMERYSHIRE,29700,29256,80.7,21.2,21.2,21.2,21.2,3.1,6.9,11.0,17.8,6.3,91.0,23982,6288,6287,934,2036,3263,5274,6287,6287,1874,27019,4669,59.6,21.2,15.7,3.1,3.7,4.1,6.8,17695,6287,934,1102,1227,2011
W07000064,CEREDIGION,34755,34491,81.4,22.2,22.2,22.2,22.2,2.9,6.8,11.1,17.8,5.0,89.2,28294,7712,7712,1017,2357,3847,6197,7712,7712,1751,31018,882,59.2,22.2,2.5,2.9,3.9,4.3,6.8,20582,7712,1017,1340,1490,2350
W07000065,PRESELI PEMBROKESHIRE,37147,37005,86.6,7.7,7.7,7.7,7.7,2.1,5.0,8.0,13.0,2.4,94.3,32158,2842,2842,797,1861,2973,4847,2842,2842,893,35024,1195,78.9,7.7,3.2,2.1,2.9,3.0,5.0,29316,2842,797,1064,1112,1874
W07000066,CARMARTHEN WEST AND SOUTH PEMBROKESHIRE,37673,37506,88.0,17.7,17.7,17.7,17.7,1.6,3.6,5.9,11.6,2.6,95.3,33154,6655,6655,602,1371,2238,4352,6653,6655,972,35890,427,70.3,17.7,1.1,1.6,2.0,2.3,5.6,26499,6655,602,769,867,2114
W07000067,CARMARTHEN EAST AND DINEFWR,33813,33284,79.2,15.7,15.7,15.7,15.7,3.2,6.8,10.5,19.3,4.4,88.3,26769,5314,5314,1087,2286,3552,6515,5314,5314,1495,29847,514,63.5,15.7,1.5,3.2,3.5,3.7,8.8,21455,5314,1087,1199,1266,2963
W07000068,BRECON AND RADNORSHIRE,33752,33074,77.0,14.8,14.8,14.8,14.8,3.5,7.2,11.8,21.0,5.0,86.3,25977,5011,5011,1169,2435,3983,7097,5009,5009,1687,29141,859,62.1,14.8,2.5,3.5,3.8,4.6,9.2,20966,5011,1169,1266,1548,3114
W07000069,NEATH,34170,34130,97.4,44.5,44.5,4.4,4.5,0.0,0.1,0.3,2.5,0.2,99.5,33265,15219,15218,5,30,90,865,1520,1521,55,34013,7629,52.8,44.5,22.3,0.0,0.1,0.2,2.3,18047,15218,5,25,60,775
W07000070,CYNON VALLEY,33473,33230,97.3,12.9,10.2,8.2,8.3,0.0,0.1,0.3,2.0,0.3,98.9,32555,4319,3400,13,27,103,675,2761,2764,101,33097,7422,87.1,10.2,22.2,0.0,0.0,0.2,1.7,29155,3400,13,14,76,572
W07000071,MERTHYR TYDFIL AND RHYMNEY,34607,34558,98.8,28.6,28.6,28.6,28.6,0.1,0.2,0.3,1.1,0.0,99.8,34180,9891,9891,37,67,102,378,9891,9891,9,34521,2836,70.2,28.6,8.2,0.1,0.1,0.1,0.8,24289,9891,37,30,35,276
W07000072,BLAENAU GWENT,32870,32814,97.1,4.9,3.5,2.4,2.4,0.0,0.1,0.3,2.7,0.0,99.7,31911,1608,1159,9,35,114,903,793,793,4,32764,15,93.6,3.5,0.0,0.0,0.1,0.2,2.4,30752,1159,9,26,79,789
W07000073,BRIDGEND,37250,37200,98.7,64.8,56.8,53.4,53.5,0.0,0.0,0.3,1.2,0.0,99.4,36752,24153,21152,2,17,113,448,19892,19913,3,37038,17777,41.9,56.8,47.7,0.0,0.0,0.3,0.9,15600,21152,2,15,96,335
W07000074,OGMORE,34584,34511,97.1,27.9,19.0,12.7,12.7,0.1,0.1,0.7,2.7,0.0,99.2,33566,9648,6578,26,48,232,945,4409,4409,10,34324,7626,78.0,19.0,22.1,0.1,0.1,0.5,2.1,26988,6578,26,22,184,713
W07000075,PONTYPRIDD,36332,36291,98.0,53.8,47.3,20.9,43.7,0.0,0.0,0.5,1.9,0.0,99.2,35618,19544,17183,11,15,195,673,7604,15876,1,36050,18441,50.7,47.3,50.8,0.0,0.0,0.5,1.3,18435,17183,11,4,180,478
W07000076,CAERPHILLY,38347,38284,98.5,41.3,34.5,31.5,31.5,0.0,0.1,0.1,1.3,0.0,99.7,37785,15841,13226,16,33,49,499,12063,12067,10,38226,26786,64.0,34.5,69.9,0.0,0.0,0.0,1.2,24559,13226,16,17,16,450
W07000077,ISLWYN,33627,33594,98.4,26.2,25.6,25.3,25.3,0.1,0.1,0.2,1.5,0.0,99.8,33085,8811,8612,18,34,76,509,8513,8513,8,33560,10552,72.8,25.6,31.4,0.1,0.0,0.1,1.3,24473,8612,18,16,42,433
W07000078,VALE OF GLAMORGAN,46198,46048,96.9,63.5,60.3,50.8,58.2,0.3,0.7,1.1,2.8,0.4,98.6,44777,29319,27872,135,338,494,1271,23476,26893,201,45536,956,36.6,60.3,2.1,0.3,0.4,0.3,1.7,16905,27872,135,203,156,777
W07000079,CARDIFF WEST,42037,41912,99.3,87.2,84.9,28.0,83.6,0.0,0.0,0.0,0.4,0.0,99.6,41723,36641,35697,1,11,15,189,11767,35142,11,41884,22562,14.3,84.9,53.7,0.0,0.0,0.0,0.4,6026,35697,1,10,4,174
W07000080,CARDIFF SOUTH AND PENARTH,51474,51390,99.2,87.5,84.4,37.7,82.5,0.0,0.4,0.5,0.6,0.0,99.3,51071,45031,43464,0,207,263,319,19391,42447,1,51118,28266,14.8,84.4,54.9,0.0,0.4,0.1,0.1,7607,43464,0,207,56,56
