laua,laua_name,All Premises,All Matched Premises,SFBB availability (% premises),UFBB availability (% premises),Full Fibre availability (% premises),% of premises unable to receive 2Mbit/s,% of premises unable to receive 5Mbit/s,% of premises unable to receive 10Mbit/s,% of premises unable to receive 30Mbit/s,% of premises below the USO,% of premises with NGA,% of premises able to receive decent broadband from FWA,% of premises able to receive SFBB from FWA,Number of premises with SFBB availability,Number of premises with UFBB availability,Number of premises with Full Fibre availability,Number of premises unable to receive 2Mbit/s,Number of premises unable to receive 5Mbit/s,Number of premises unable to receive 10Mbit/s,Number of premises unable to receive 30Mbit/s,Number of premises below the USO,Number of premises with NGA,Number of premises able to receive decent broadband from FWA,Number of premises able to receive SFBB from FWA,Number of premises with 30<300Mbit/s download speed,Number of premises with >=300Mbit/s download speed,Number of premises with 0<2Mbit/s download speed,Number of premises with 2<5Mbit/s download speed,Number of premises with 5<10Mbit/s download speed,Number of premises with 10<30Mbit/s download speed,% of premises with 30<300Mbit/s download speed,% of premises with >=300Mbit/s download speed,% of premises with 0<2Mbit/s download speed,% of premises with 2<5Mbit/s download speed,% of premises with 5<10Mbit/s download speed,% of premises with 10<30Mbit/s download speed
S12000033,ABERDEEN CITY,125441,125311,73.3,20.1,13.1,0,0.2,0.7,6.5,0.2,96.8,0,0,117152,25163,16410,49,219,884,8159,189,121476,0,0,91989,25163,49,170,665,7275,73.3,20.1,0,0.1,0.5,5.8
S12000034,ABERDEENSHIRE,125085,124305,78.5,2.8,2.7,2.5,5.9,9.9,18.1,3.6,93.6,0,0,101652,3472,3332,3163,7339,12332,22653,4519,117051,0,0,98180,3472,3163,4176,4993,10321,78.5,2.8,2.5,3.3,4,8.3
E07000223,ADUR,29770,29760,16.3,82.4,0.6,0,0.1,0.1,1.3,0,99.1,0,0,29383,24543,193,0,16,44,377,12,29514,0,0,4840,24543,0,16,28,333,16.3,82.4,0,0.1,0.1,1.1
E07000026,ALLERDALE,51385,51284,89.8,1.7,1.7,1.2,2.6,3.6,8.3,1.2,98.3,2.3,2.2,47003,866,866,619,1323,1873,4281,592,50507,1164,1114,46137,866,619,704,550,2408,89.8,1.7,1.2,1.4,1.1,4.7
E07000032,AMBER VALLEY,60674,60596,67.4,25.3,22.1,0.1,0.9,2.1,7.2,0.7,98.2,0,0,56232,15339,13412,89,549,1254,4364,440,59578,0,0,40893,15339,89,460,705,3110,67.4,25.3,0.1,0.8,1.2,5.1
S12000041,ANGUS,60535,60197,72.3,13.6,1.4,1.4,3.8,7.1,13.6,2.2,94.5,0,0,51963,8213,818,859,2278,4304,8234,1340,57230,0,0,43750,8213,859,1419,2026,3930,72.3,13.6,1.4,2.3,3.3,6.5
N09000001,ANTRIM AND NEWTOWNABBEY,61064,60526,36.5,54.5,24,1.6,2.9,3.9,8.1,1.6,98.3,0,0,55588,33274,14650,998,1799,2359,4938,995,60052,0,0,22314,33274,998,801,560,2579,36.5,54.5,1.6,1.3,0.9,4.2
N09000011,ARDS AND NORTH DOWN,72717,72510,32.1,62.4,57.3,0.5,1.1,2.2,5.3,0.8,99.5,0,0,68678,45343,41699,387,828,1597,3832,549,72371,0,0,23335,45343,387,441,769,2235,32.1,62.4,0.5,0.6,1.1,3.1
S12000035,ARGYLL AND BUTE,56131,54748,75.3,0.9,0.9,3.3,6.4,11.6,21.3,6.8,87.3,0,0,42782,488,487,1876,3578,6513,11966,3804,49017,0,0,42294,488,1876,1702,2935,5453,75.3,0.9,3.3,3,5.2,9.7
N09000002,"ARMAGH CITY, BANBRIDGE AND CRAIGAVON",86230,85767,51.7,36.1,36.3,1.6,3.2,5,11.7,2,98.3,0,0,75658,31107,31283,1341,2742,4296,10109,1693,84753,1,0,44551,31107,1341,1401,1554,5813,51.7,36.1,1.6,1.6,1.8,6.7
E07000224,ARUN,78405,78393,91.5,5.1,2.8,0.1,0.1,0.3,3.4,0.1,99.7,0,0,75750,4006,2208,56,103,248,2643,70,78184,0,0,71744,4006,56,47,145,2395,91.5,5.1,0.1,0.1,0.2,3.1
E07000170,ASHFIELD,59438,59417,14.6,83.7,1.4,0,0.4,0.5,1.6,0.2,99.2,0,0,58450,49778,804,12,227,295,967,92,58961,0,0,8672,49778,12,215,68,672,14.6,83.7,0,0.4,0.1,1.1
E07000105,ASHFORD,57809,57766,46.2,43.3,4.9,0.4,1.9,3.9,10.4,1,98.3,0,0,51740,25042,2841,219,1075,2281,6026,554,56807,0,0,26698,25042,219,856,1206,3745,46.2,43.3,0.4,1.5,2.1,6.5
E07000004,AYLESBURY VALE,88230,88194,48.5,43.1,11.4,0.5,1.7,3.2,8.4,0.6,96.1,0,0,80812,38056,10085,449,1503,2810,7382,510,84800,0,0,42756,38056,449,1054,1307,4572,48.5,43.1,0.5,1.2,1.5,5.2
E07000200,BABERGH,43124,43078,82,10.3,6.3,0.5,1.1,1.8,7.5,0.5,98.9,0,0,39832,4461,2702,197,471,787,3246,235,42656,0,0,35371,4461,197,274,316,2459,82,10.3,0.5,0.6,0.7,5.7
E09000002,BARKING AND DAGENHAM,80961,80431,8.9,89.4,46.3,0,0.3,0.4,1,0.7,98.3,0,0,79595,72375,37476,18,232,363,836,562,79606,0,0,7220,72375,18,214,131,473,8.9,89.4,0,0.3,0.2,0.6
E09000003,BARNET,157764,157751,45.9,51.2,18,0,0,0.1,2.9,0,98.2,0,0,153230,80770,28380,0,12,157,4521,11,154976,0,0,72460,80770,0,12,145,4364,45.9,51.2,0,0,0.1,2.8
E08000016,BARNSLEY,116713,116685,42.6,54.8,14.3,0.1,0.3,0.5,2.5,0.1,99.2,0,0,113767,63994,16648,122,311,589,2918,59,115830,0,0,49773,63994,122,189,278,2329,42.6,54.8,0.1,0.2,0.2,2
E07000027,BARROW-IN-FURNESS,35421,35396,97.8,0.7,0.7,0.2,0.2,0.4,1.5,0.1,99.9,0.1,0.1,34870,242,242,54,82,150,526,46,35386,35,35,34628,242,54,28,68,376,97.8,0.7,0.2,0.1,0.2,1.1
E07000066,BASILDON,83511,83423,29.1,66.9,11.4,0,0.3,0.9,3.8,0.1,99,0,0,80224,55889,9486,13,210,750,3199,86,82640,0,0,24335,55889,13,197,540,2449,29.1,66.9,0,0.2,0.6,2.9
E07000084,BASINGSTOKE AND DEANE,80300,80277,50.6,44.5,17.2,0.4,1,2,4.9,0.7,98.7,0,0,76340,35696,13798,338,843,1567,3937,540,79230,0,0,40644,35696,338,505,724,2370,50.6,44.5,0.4,0.6,0.9,3
E07000171,BASSETLAW,55314,55240,66.8,28.4,4.4,0.4,0.8,1.2,4.8,0.3,99.3,6.7,4.9,52611,15685,2415,240,433,665,2629,171,54929,3723,2718,36926,15685,240,193,232,1964,66.8,28.4,0.4,0.3,0.4,3.6
E06000022,BATH AND NORTH EAST SOMERSET,88110,88040,46.3,43.7,16.4,0.3,0.7,1.9,9.9,0.6,94.4,0,0,79285,38500,14412,221,593,1657,8755,503,83217,0,0,40785,38500,221,372,1064,7098,46.3,43.7,0.3,0.4,1.2,8.1
E06000055,BEDFORD,80238,80223,26.6,69.5,7.4,0.2,0.5,0.9,3.9,0.1,98.7,0,0,77125,55755,5919,132,406,755,3098,118,79195,0,0,21370,55755,132,274,349,2343,26.6,69.5,0.2,0.3,0.4,2.9
N09000003,BELFAST,167104,166414,8.8,88.5,43.3,0,0.1,0.4,2.3,0.4,97.6,0,0,162622,147912,72273,26,125,729,3792,702,163058,0,0,14710,147912,26,99,604,3063,8.8,88.5,0,0.1,0.4,1.8
E09000004,BEXLEY,103193,103144,21.6,74.7,11.8,0,0.1,1.1,3.6,0.1,97,0,0,99380,77075,12193,27,143,1153,3764,78,100108,0,0,22305,77075,27,116,1010,2611,21.6,74.7,0,0.1,1,2.5
E08000025,BIRMINGHAM,469208,468772,14.3,80.8,20.6,0,0.1,0.9,4.8,0.1,95.1,0,0,446234,379277,96588,78,565,4348,22538,462,446416,0,0,66957,379277,78,487,3783,18190,14.3,80.8,0,0.1,0.8,3.9
E07000129,BLABY,45018,45005,33.5,64.2,33.5,0.1,0.3,0.4,2.3,0,98.9,0,0,43967,28905,15074,32,132,189,1038,14,44508,0,0,15062,28905,32,100,57,849,33.5,64.2,0.1,0.2,0.1,1.9
E06000008,BLACKBURN WITH DARWEN,67155,67114,35.9,61.5,3.8,0.1,0.3,0.5,2.5,0.1,99.2,46.7,22.7,65458,41317,2553,42,200,361,1656,62,66606,31365,15223,24141,41317,42,158,161,1295,35.9,61.5,0.1,0.2,0.2,1.9
E06000009,BLACKPOOL,76502,76458,34.4,64.5,0.4,0,0,0,1,0,99,0,0,75665,49337,295,0,10,28,793,30,75765,0,0,26328,49337,0,10,18,765,34.4,64.5,0,0,0,1
W06000019,BLAENAU GWENT,35203,35163,95.6,1.3,1.3,0,0.2,0.8,3,0.2,99.3,0,0,34111,460,460,15,61,270,1052,70,34957,14,0,33651,460,15,46,209,782,95.6,1.3,0,0.1,0.6,2.2
E07000033,BOLSOVER,38320,38308,66.1,27.4,3.7,0.2,0.4,0.9,6.5,0.2,98.6,0,0,35802,10482,1419,73,172,348,2506,68,37782,0,0,25320,10482,73,99,176,2158,66.1,27.4,0.2,0.3,0.5,5.6
E08000001,BOLTON,133392,133277,30,68.3,0.8,0,0.1,0.3,1.6,0.1,99.2,4.4,2.5,131124,91140,1052,32,148,410,2153,112,132304,5895,3392,39984,91140,32,116,262,1743,30,68.3,0,0.1,0.2,1.3
E07000136,BOSTON,32932,32823,86.9,2.7,2.7,1.1,2.5,3.6,10,1.5,97.5,2.9,2.9,29533,905,905,374,812,1175,3290,507,32106,966,963,28628,905,374,438,363,2115,86.9,2.7,1.1,1.3,1.1,6.4
E06000058,"BOURNEMOUTH, CHRISTCHURCH AND POOLE",195937,195809,21.2,77.4,13.8,0.2,0.2,0.3,1.3,0.1,99.3,0,0,193193,151691,27110,353,404,633,2616,155,194616,0,0,41502,151691,353,51,229,1983,21.2,77.4,0.2,0,0.1,1
E06000036,BRACKNELL FOREST,52049,52044,44.8,50.5,4.1,0.1,0.3,1.4,4.6,0.1,98.1,0,0,49624,26295,2137,77,169,731,2420,53,51055,0,0,23329,26295,77,92,562,1689,44.8,50.5,0.1,0.2,1.1,3.2
E08000032,BRADFORD,214823,214391,31.5,64.8,2.2,0.1,0.3,0.6,3.5,0.2,97.9,44.3,16.2,206946,139267,4781,169,636,1344,7445,457,210221,95210,34702,67679,139267,169,467,708,6101,31.5,64.8,0.1,0.2,0.3,2.8
E07000067,BRAINTREE,70641,70575,85.1,2.5,2.5,0.9,2.5,4,12.3,1.8,94.2,0,0,61904,1789,1752,626,1761,2839,8671,1275,66518,0,0,60115,1789,626,1135,1078,5832,85.1,2.5,0.9,1.6,1.5,8.3
E07000143,BRECKLAND,65639,65510,83.4,3.8,2.4,0.9,2.5,4.5,12.6,2.2,96.6,0,0,57239,2526,1577,584,1609,2933,8271,1421,63438,0,0,54713,2526,584,1025,1324,5338,83.4,3.8,0.9,1.6,2,8.1
E09000005,BRENT,131468,131248,41.4,55.6,13.5,0,0.1,0.5,2.8,0.2,97.3,0,0,127567,73076,17688,5,77,593,3681,217,127887,0,0,54491,73076,5,72,516,3088,41.4,55.6,0,0.1,0.4,2.3
E07000068,BRENTWOOD,35373,35359,91.3,2.6,2.6,0.1,0.3,0.6,6,0.1,99,0,0,33219,924,923,48,118,206,2140,41,35035,0,0,32295,924,48,70,88,1934,91.3,2.6,0.1,0.2,0.2,5.5
W06000013,BRIDGEND,66762,66734,78.6,16.4,9.2,0.1,0.2,0.9,4.9,0.1,98.7,29.1,18.2,63456,10965,6145,62,113,633,3278,37,65873,19430,12175,52491,10965,62,51,520,2645,78.6,16.4,0.1,0.1,0.8,4
E06000043,BRIGHTON AND HOVE,144949,144787,20,77.5,1.5,0,0,0.5,2.3,0.1,97.8,0,0,141399,112362,2144,4,70,727,3388,162,141759,0,0,29037,112362,4,66,657,2661,20,77.5,0,0,0.5,1.8
E06000023,"BRISTOL, CITY OF",213743,213506,10.8,84.5,32.9,0,0,0.5,4.6,0.1,95.4,0,0,203652,180610,70325,7,100,996,9854,260,203865,0,0,23042,180610,7,93,896,8858,10.8,84.5,0,0,0.4,4.1
E07000144,BROADLAND,61326,61207,55.2,37,5.7,0.5,1.5,3,7.6,1.5,98,0,0,56544,22718,3503,315,936,1864,4663,939,60074,0,0,33826,22718,315,621,928,2799,55.2,37,0.5,1,1.5,4.6
E09000006,BROMLEY,145702,145682,16.1,81.2,0.8,0,0.2,0.6,2.7,0,98.3,0,0,141814,118324,1232,57,356,814,3868,64,143259,0,0,23490,118324,57,299,458,3054,16.1,81.2,0,0.2,0.3,2.1
E07000234,BROMSGROVE,44955,44917,66.3,27.7,7.3,0.3,1,1.6,6,0.3,99,1.6,0,42234,12434,3300,156,444,732,2683,139,44527,719,13,29800,12434,156,288,288,1951,66.3,27.7,0.3,0.6,0.6,4.3
E07000095,BROXBOURNE,42893,42883,14.6,83.9,0.7,0.1,0.1,0.3,1.5,0,99.3,0,0,42256,35998,315,28,50,116,627,21,42598,0,0,6258,35998,28,22,66,511,14.6,83.9,0.1,0.1,0.2,1.2
E07000172,BROXTOWE,52229,52221,9.5,89.5,0.6,0,0.1,0.2,0.9,0,99.7,0,0,51749,46768,308,15,64,96,472,7,52051,0,0,4981,46768,15,49,32,376,9.5,89.5,0,0.1,0.1,0.7
E07000117,BURNLEY,45164,45111,34,64,0.6,0.1,0.1,0.3,1.8,0.1,99.5,45.4,11.3,44287,28917,285,37,48,139,824,58,44917,20522,5085,15370,28917,37,11,91,685,34,64,0.1,0,0.2,1.5
E08000002,BURY,87488,87189,51.2,45.7,9.5,0,0.1,0.2,2.7,0.3,99.5,0.1,0,84839,40007,8346,13,93,184,2350,300,87063,99,0,44832,40007,13,80,91,2166,51.2,45.7,0,0.1,0.1,2.5
W06000018,CAERPHILLY,82696,82682,85.7,11.1,7,0,0.1,0.3,3.2,0,99.8,32.2,23.7,80077,9199,5755,36,112,255,2605,20,82553,26621,19624,70878,9199,36,76,143,2350,85.7,11.1,0,0.1,0.2,2.8
E08000033,CALDERDALE,103617,103603,52.3,41.5,3.5,0.1,0.4,0.9,6.2,0.1,98.6,0,0,97174,43006,3586,119,428,909,6429,82,102138,26,25,54168,43006,119,309,481,5520,52.3,41.5,0.1,0.3,0.5,5.3
E07000008,CAMBRIDGE,60442,60368,12.9,85.2,6.1,0,0,0.3,1.8,0.1,98.3,0.4,0,59307,51482,3676,0,20,199,1061,73,59402,268,0,7825,51482,0,20,179,862,12.9,85.2,0,0,0.3,1.4
E09000007,CAMDEN,120547,120300,13.1,82.3,10.5,0,0,0,4.4,0.2,95.4,0,0,115016,99209,12637,0,0,43,5284,246,115019,0,0,15807,99209,0,0,43,5241,13.1,82.3,0,0,0,4.3
E07000192,CANNOCK CHASE,47009,46997,74.7,22.3,0.7,0,0.1,0.1,3,0.1,99.2,0,0,45586,10463,313,9,32,40,1411,35,46644,0,0,35123,10463,9,23,8,1371,74.7,22.3,0,0,0,2.9
E07000106,CANTERBURY,74498,74323,90.6,2.1,2.1,0.3,0.7,1.4,7.1,0.4,99.3,0,0,69037,1551,1551,212,532,1016,5286,274,73953,0,0,67486,1551,212,320,484,4270,90.6,2.1,0.3,0.4,0.6,5.7
W06000015,CARDIFF,166726,166179,18.2,78.7,29.5,0,0.1,0.5,2.8,0.3,97.6,54.2,26,161588,131276,49236,29,239,894,4591,511,162721,90314,43367,30312,131276,29,210,655,3697,18.2,78.7,0,0.1,0.4,2.2
E07000028,CARLISLE,56553,56482,48.3,44.9,3,0.8,1.8,3.2,6.7,1.2,97.2,0.1,0.1,52703,25379,1700,469,1037,1806,3779,663,54963,36,36,27324,25379,469,568,769,1973,48.3,44.9,0.8,1,1.4,3.5
W06000010,CARMARTHENSHIRE,92611,92273,73.7,12.4,12.4,1.9,4.3,6.8,13.5,2.2,93.8,12.3,8.1,79798,11504,11504,1742,3940,6278,12475,2030,86905,11359,7484,68294,11504,1742,2198,2338,6197,73.7,12.4,1.9,2.4,2.5,6.7
E07000069,CASTLE POINT,40841,40747,54.8,43.9,2.9,0,0.2,0.2,1.1,0.2,99.6,0,0,40304,17926,1168,7,65,90,443,92,40667,0,0,22378,17926,7,58,25,353,54.8,43.9,0,0.1,0.1,0.9
N09000004,CAUSEWAY COAST AND GLENS,66175,64788,69.9,14.8,14.8,2.3,4.4,6.3,13.1,3.8,97.2,0,0,56086,9798,9791,1543,2914,4143,8702,2539,64347,0,0,46288,9798,1543,1371,1229,4559,69.9,14.8,2.3,2.1,1.9,6.9
E06000056,CENTRAL BEDFORDSHIRE,124905,124893,35.6,60.3,6,0.1,0.7,1.3,4.1,0.2,98.7,0,0,119807,75356,7546,148,898,1593,5086,221,123288,0,0,44451,75356,148,750,695,3493,35.6,60.3,0.1,0.6,0.6,2.8
W06000008,CEREDIGION,37454,37282,60.8,20,20,2.8,6.5,10.9,18.7,4.4,90.5,3.3,2.6,30261,7504,7504,1035,2424,4101,7021,1636,33880,1231,986,22757,7504,1035,1389,1677,2920,60.8,20,2.8,3.7,4.5,7.8
E07000130,CHARNWOOD,77672,77653,27.6,70.4,9.1,0.1,0.2,0.6,2,0.1,99.2,0,0,76105,54677,7074,80,183,494,1548,48,77052,0,0,21428,54677,80,103,311,1054,27.6,70.4,0.1,0.1,0.4,1.4
E07000070,CHELMSFORD,81702,81687,47.8,45.6,5.1,0.2,0.6,1.2,6.5,0.3,98.1,0,0,76354,37278,4199,168,494,1003,5333,211,80115,0,0,39076,37278,168,326,509,4330,47.8,45.6,0.2,0.4,0.6,5.3
E07000078,CHELTENHAM,59881,59860,28.6,69.1,4.8,0.1,0.2,0.7,2.2,0,98.8,0,0,58515,41378,2882,31,139,393,1345,27,59134,0,0,17137,41378,31,108,254,952,28.6,69.1,0.1,0.2,0.4,1.6
E07000177,CHERWELL,69638,69577,58.8,36.2,8.5,0.2,0.4,1.1,5,0.2,97.9,0,0,66127,25192,5953,148,279,780,3450,171,68185,0,0,40935,25192,148,131,501,2670,58.8,36.2,0.2,0.2,0.7,3.8
E06000049,CHESHIRE EAST,188553,188437,60,32.3,4.1,0.4,1,1.9,7.6,0.3,98.2,5.2,0.6,174073,60959,7690,660,1792,3661,14364,571,185085,9818,1191,113114,60959,660,1132,1869,10703,60,32.3,0.4,0.6,1,5.7
E06000050,CHESHIRE WEST AND CHESTER,169539,169449,70.3,24,5.8,0.2,0.6,1.2,5.7,0.2,98.8,5.9,0,159817,40609,9897,298,1056,2094,9632,294,167496,9980,0,119208,40609,298,758,1038,7538,70.3,24,0.2,0.4,0.6,4.4
E07000034,CHESTERFIELD,53019,52992,62.5,33.8,3.2,0,0.1,0.4,3.6,0,99.4,0,0,51086,17936,1706,12,65,190,1906,23,52688,0,0,33150,17936,12,53,125,1716,62.5,33.8,0,0.1,0.2,3.2
E07000225,CHICHESTER,61791,61623,71.3,19.5,18.2,0.5,1.2,2.4,8.9,1.1,98.7,0,0,56098,12022,11259,333,730,1500,5525,704,60969,0,0,44076,12022,333,397,770,4025,71.3,19.5,0.5,0.6,1.2,6.5
E07000005,CHILTERN,42619,42614,48.9,43.4,0.7,0.1,0.3,0.7,7.7,0.1,99.5,0,0,39325,18499,301,27,120,318,3289,56,42422,0,0,20826,18499,27,93,198,2971,48.9,43.4,0.1,0.2,0.5,7
E07000118,CHORLEY,53982,53952,46,48.6,4.2,0.1,0.9,1.6,5.4,0.1,98.4,43.3,22.5,51051,26222,2266,35,460,866,2901,40,53093,23379,12124,24829,26222,35,425,406,2035,46,48.6,0.1,0.8,0.8,3.8
S12000036,CITY OF EDINBURGH,264131,264113,15.5,81.7,21.4,0,0.2,0.4,2.8,0,97.7,0,0,256682,215687,56447,116,633,1149,7431,49,257960,0,0,40995,215687,116,517,516,6282,15.5,81.7,0,0.2,0.2,2.4
E09000001,CITY OF LONDON,10077,10071,32.8,21.1,20.6,0,0,0,46,0.1,53.9,0,0,5434,2125,2077,0,0,1,4637,6,5434,0,0,3309,2125,0,0,1,4636,32.8,21.1,0,0,0,46
S12000005,CLACKMANNANSHIRE,25515,25490,89,5.1,0.6,0.1,0.2,0.4,5.8,0.2,99.7,0,0,23999,1293,165,27,44,100,1491,52,25437,0,0,22706,1293,27,17,56,1391,89,5.1,0.1,0.1,0.2,5.5
E07000071,COLCHESTER,87145,86763,43.8,48.3,5.4,0.7,1.9,3.3,7.5,1.3,95.5,0,0,80246,42105,4746,575,1634,2860,6517,1136,83209,0,0,38141,42105,575,1059,1226,3657,43.8,48.3,0.7,1.2,1.4,4.2
W06000003,CONWY,59172,59130,88.7,4.1,4.1,0.7,1.9,3.1,7.2,1.1,97.4,50.6,35.9,54886,2413,2413,405,1145,1863,4244,645,57651,29932,21268,52473,2413,405,740,718,2381,88.7,4.1,0.7,1.3,1.2,4
E07000029,COPELAND,35488,35446,93.4,1.2,1.2,0.3,0.8,1.6,5.3,0.9,99.2,0,0,33576,426,426,100,272,553,1870,303,35192,0,0,33150,426,100,172,281,1317,93.4,1.2,0.3,0.5,0.8,3.7
E07000150,CORBY,32358,32284,36.7,61.2,14.3,0.2,0.6,0.7,1.8,0.5,98.6,0,0,31709,19818,4624,51,194,215,575,163,31906,0,0,11891,19818,51,143,21,360,36.7,61.2,0.2,0.4,0.1,1.1
E06000052,CORNWALL,297017,296180,54,36.2,33.2,0.4,1.2,2.6,9.5,0.9,96.2,3.4,1.3,267957,107513,98722,1158,3705,7588,28223,2623,285606,10230,3980,160444,107513,1158,2547,3883,20635,54,36.2,0.4,0.9,1.3,6.9
E07000079,COTSWOLD,46730,46714,59.3,29.7,29.5,0.3,1,3.3,11,1,92.2,0.1,0.1,41570,13856,13808,125,450,1565,5144,488,43082,48,48,27714,13856,125,325,1115,3579,59.3,29.7,0.3,0.7,2.4,7.7
E06000047,COUNTY DURHAM,258298,258152,83.9,9,4.4,0.3,0.8,1.6,6.9,0.4,98.7,0.2,0,240206,23370,11324,878,2157,4022,17946,1042,255025,636,78,216836,23370,878,1279,1865,13924,83.9,9,0.3,0.5,0.7,5.4
E08000026,COVENTRY,148564,148210,17.9,77.7,34.4,0,0.5,1.1,4.1,0.3,96.2,0,0,142083,115422,51178,10,729,1590,6127,372,142894,0,0,26661,115422,10,719,861,4537,17.9,77.7,0,0.5,0.6,3.1
E07000163,CRAVEN,29887,29825,77.7,12.7,8.6,1.3,2.4,4.1,9.3,0.8,96.9,37.2,24.1,27032,3799,2584,385,732,1215,2793,248,28973,11109,7211,23233,3799,385,347,483,1578,77.7,12.7,1.3,1.2,1.6,5.3
E07000226,CRAWLEY,48273,48262,14.8,84.2,1.9,0,0.1,0.2,0.9,0,99.8,0,0,47807,40666,936,4,26,81,455,17,48159,0,0,7141,40666,4,22,55,374,14.8,84.2,0,0,0.1,0.8
E09000008,CROYDON,166730,166668,24,71.7,15,0,0,0.3,4.2,0.1,96.4,0,0,159588,119524,25079,1,63,510,7080,96,160682,0,0,40064,119524,1,62,447,6570,24,71.7,0,0,0.3,3.9
E07000096,DACORUM,68378,68340,26.8,68.3,2.7,0.2,0.5,1.4,4.9,0.2,98.3,0,0,64995,46703,1837,109,321,966,3345,123,67229,0,0,18292,46703,109,212,645,2379,26.8,68.3,0.2,0.3,0.9,3.5
E06000005,DARLINGTON,53905,53869,10.7,82.6,1.4,0.6,2.2,3.5,6.7,0.4,94.8,18.4,3.9,50275,44529,758,347,1190,1880,3594,192,51117,9914,2082,5746,44529,347,843,690,1714,10.7,82.6,0.6,1.6,1.3,3.2
E07000107,DARTFORD,48684,48671,46.9,48.4,11.1,0.3,0.6,1.5,4.7,0.1,97.7,0,0,46396,23566,5408,124,314,751,2275,34,47571,0,0,22830,23566,124,190,437,1524,46.9,48.4,0.3,0.4,0.9,3.1
E07000151,DAVENTRY,37772,37752,67.7,25.4,20.5,0.5,1.3,2.4,6.8,0.2,97.5,0,0,35176,9595,7746,174,494,925,2576,91,36846,0,0,25581,9595,174,320,431,1651,67.7,25.4,0.5,0.8,1.1,4.4
W06000004,DENBIGHSHIRE,49215,49094,84.7,5.6,5.6,0.8,1.9,4.1,9.5,1,95.2,47.7,2.6,44424,2756,2756,381,919,1994,4670,495,46837,23493,1303,41668,2756,381,538,1075,2676,84.7,5.6,0.8,1.1,2.2,5.4
E06000015,DERBY,118416,118355,11.8,87.3,4.3,0,0,0.1,0.9,0,99.4,0,0,117296,103379,5120,1,20,143,1059,59,117750,0,0,13917,103379,1,19,123,916,11.8,87.3,0,0,0.1,0.8
E07000035,DERBYSHIRE DALES,37136,37079,79.9,5.2,5.2,0.6,2.7,6.2,14.7,1.8,94.5,0,0,31622,1942,1942,241,1003,2319,5457,655,35103,0,0,29680,1942,241,762,1316,3138,79.9,5.2,0.6,2.1,3.5,8.5
N09000005,DERRY CITY AND STRABANE,62612,62399,22.4,68.1,20.7,2.1,3.6,4.9,9.1,2.6,98.7,0,0,56678,42640,12980,1335,2265,3075,5721,1650,61786,0,0,14038,42640,1335,930,810,2646,22.4,68.1,2.1,1.5,1.3,4.2
E08000017,DONCASTER,145582,145541,54.5,41.8,7.6,0.1,0.4,0.8,3.6,0.1,98.7,14.7,14,140272,60860,11037,127,583,1100,5269,90,143728,21388,20312,79412,60860,127,456,517,4169,54.5,41.8,0.1,0.3,0.4,2.9
E06000059,DORSET,188664,188183,85.2,5.7,3.3,0.3,1.2,2.2,8.9,0.6,98.1,7.6,7.6,171435,10720,6197,637,2197,4123,16748,1225,185156,14324,14324,160715,10720,637,1560,1926,12625,85.2,5.7,0.3,0.8,1,6.7
E07000108,DOVER,55242,55206,63.9,28.4,1.8,0.5,1,2.1,7.7,0.3,98.2,0,0,50971,15669,1009,293,565,1153,4235,158,54246,0,0,35302,15669,293,272,588,3082,63.9,28.4,0.5,0.5,1.1,5.6
E08000027,DUDLEY,146645,146530,18.2,80.9,0.5,0,0,0.1,0.8,0.1,99.5,0.3,0,145386,118666,733,0,13,88,1144,110,145924,385,0,26720,118666,0,13,75,1056,18.2,80.9,0,0,0.1,0.7
S12000006,DUMFRIES AND GALLOWAY,81674,81180,79.8,4.2,4.2,1.9,4.6,8,15.4,3.3,95.7,0,0,68620,3431,3431,1563,3748,6517,12560,2665,78160,0,0,65189,3431,1563,2185,2769,6043,79.8,4.2,1.9,2.7,3.4,7.4
S12000042,DUNDEE CITY,79242,79232,13.6,84.7,0.7,0,0,0.3,1.7,0,98.9,0,0,77891,67132,518,1,15,254,1341,12,78394,0,0,10759,67132,1,14,239,1087,13.6,84.7,0,0,0.3,1.4
E09000009,EALING,147016,146936,31.1,67.2,11.2,0,0,0.4,1.6,0,98.4,0,0,144536,98802,16465,0,47,532,2400,64,144620,0,0,45734,98802,0,47,485,1868,31.1,67.2,0,0,0.3,1.3
S12000008,EAST AYRSHIRE,59191,59143,59.8,34.4,4.6,0.6,1.4,3,5.7,0.3,97.6,0,0,55748,20343,2724,359,844,1750,3395,199,57775,0,0,35405,20343,359,485,906,1645,59.8,34.4,0.6,0.8,1.5,2.8
E07000009,EAST CAMBRIDGESHIRE,39248,39204,63.7,29.4,3,0.6,1.3,2.5,6.8,0.4,98.7,30.8,26.4,36522,11530,1182,235,521,987,2682,170,38751,12071,10369,24992,11530,235,286,466,1695,63.7,29.4,0.6,0.7,1.2,4.3
E07000040,EAST DEVON,73549,73507,78.5,8,5,0.6,2.6,5.4,13.4,0.8,95.2,19.2,0.7,63621,5886,3678,424,1909,3963,9886,594,70012,14110,524,57735,5886,424,1485,2054,5923,78.5,8,0.6,2,2.8,8.1
S12000045,EAST DUNBARTONSHIRE,48879,48863,21.3,74.7,2.4,0.1,0.2,0.6,4,0.1,98.3,0,0,46923,36489,1197,42,91,278,1940,28,48052,0,0,10434,36489,42,49,187,1662,21.3,74.7,0.1,0.1,0.4,3.4
E07000085,EAST HAMPSHIRE,57198,56978,59.4,31.1,4.9,0.3,0.9,2,9.1,1.1,97,0,0,51776,17812,2814,182,540,1159,5202,606,55475,0,0,33964,17812,182,358,619,4043,59.4,31.1,0.3,0.6,1.1,7.1
E07000242,EAST HERTFORDSHIRE,65545,65530,32.5,60.8,3.8,0.2,0.8,1.5,6.7,0.5,96.8,0,0,61158,39864,2472,107,507,986,4372,348,63432,0,0,21294,39864,107,400,479,3386,32.5,60.8,0.2,0.6,0.7,5.2
E07000137,EAST LINDSEY,71802,71630,73.4,12.7,2.2,1.2,3.4,6.1,13.6,2.4,97.2,11.1,5.2,61834,9125,1590,856,2434,4369,9796,1747,69788,7950,3724,52709,9125,856,1578,1935,5427,73.4,12.7,1.2,2.2,2.7,7.6
S12000010,EAST LOTHIAN,48580,48529,83.5,8.2,8.2,0.4,1.5,2.5,8.1,0.4,97.5,27.2,26.7,44570,3987,3988,203,721,1225,3959,213,47370,13201,12972,40583,3987,203,518,504,2734,83.5,8.2,0.4,1.1,1,5.6
E07000152,EAST NORTHAMPTONSHIRE,42826,42805,42.1,54.8,10.3,0.1,0.4,0.7,3,0.3,98.8,0,0,41503,23474,4397,40,178,298,1302,117,42307,1,0,18029,23474,40,138,120,1004,42.1,54.8,0.1,0.3,0.3,2.3
S12000011,EAST RENFREWSHIRE,40711,40704,27.2,68.2,1.7,0.2,0.4,0.7,4.6,0.1,98.5,0,0,38824,27759,689,94,156,290,1880,37,40081,0,0,11065,27759,94,62,134,1590,27.2,68.2,0.2,0.2,0.3,3.9
E06000011,EAST RIDING OF YORKSHIRE,164270,163400,52.9,41,40.2,0.5,1,1.7,5.5,0.3,97.2,32.4,25.2,154289,67359,66047,770,1626,2781,9111,491,159707,53173,41432,86930,67359,770,856,1155,6330,52.9,41,0.5,0.5,0.7,3.9
E07000193,EAST STAFFORDSHIRE,54923,54862,69.9,24,19.7,0.3,0.8,1.7,6,0.4,98.8,0,0,51548,13155,10797,149,445,920,3314,233,54257,0,0,38393,13155,149,296,475,2394,69.9,24,0.3,0.5,0.9,4.4
E07000244,EAST SUFFOLK,126027,125867,81.2,11.1,4.7,0.4,1.1,2.2,7.6,0.9,97.7,0,0,116322,14007,5949,442,1415,2758,9545,1151,123191,0,0,102315,14007,442,973,1343,6787,81.2,11.1,0.4,0.8,1.1,5.4
E07000061,EASTBOURNE,50590,50580,97.7,1,1,0,0,0.1,1.3,0,99.5,0,0,49928,504,504,0,6,54,652,8,50315,0,0,49424,504,0,6,48,598,97.7,1,0,0,0.1,1.2
E07000086,EASTLEIGH,59443,59403,39.7,56.8,5.7,0,0,0.2,3.5,0.1,98.6,0,0,57348,33773,3372,0,28,112,2055,42,58629,0,0,23575,33773,0,28,84,1943,39.7,56.8,0,0,0.1,3.3
E07000030,EDEN,29493,29356,76.6,3.3,3.3,4.3,8.2,11.4,19.7,2.4,94.8,4.8,4.2,23551,970,970,1262,2423,3354,5805,711,27964,1418,1247,22581,970,1262,1161,931,2451,76.6,3.3,4.3,3.9,3.2,8.3
E07000207,ELMBRIDGE,60054,60014,23,75.5,2.9,0,0,0.1,1.5,0.1,99.8,0,0,59135,45317,1730,9,24,45,879,40,59929,0,0,13818,45317,9,15,21,834,23,75.5,0,0,0,1.4
E09000010,ENFIELD,131957,131234,19.7,77.6,2.1,0,0.1,0.7,2.2,0.5,97.6,0,0,128337,102340,2729,33,128,876,2897,710,128842,0,0,25997,102340,33,95,748,2021,19.7,77.6,0,0.1,0.6,1.5
E07000072,EPPING FOREST,61440,61342,19.2,73.5,8.1,0.2,0.8,1.9,7.2,0.5,95.6,0,0,56922,45134,4951,102,506,1162,4420,327,58726,0,0,11788,45134,102,404,656,3258,19.2,73.5,0.2,0.7,1.1,5.3
E07000208,EPSOM AND EWELL,33082,33080,19.5,79.7,3,0,0.1,0.2,0.8,0,99.5,0,0,32822,26358,978,0,46,50,258,2,32904,0,0,6464,26358,0,46,4,208,19.5,79.7,0,0.1,0,0.6
E07000036,EREWASH,55564,55510,24.3,73.6,0.6,0.1,0.4,0.5,2,0.1,99.5,0,0,54411,40901,351,75,199,288,1099,43,55298,0,0,13510,40901,75,124,89,811,24.3,73.6,0.1,0.2,0.2,1.5
E07000041,EXETER,57828,57782,14.5,80.5,35,0,0.2,1.7,4.9,0.1,95.8,46.2,12.8,54937,46562,20234,26,110,978,2845,54,55399,26736,7411,8375,46562,26,84,868,1867,14.5,80.5,0,0.1,1.5,3.2
S12000014,FALKIRK,73620,73593,18.6,78.2,1,0.1,0.5,1,3.2,0.2,98.5,0,0,71272,57594,752,61,333,728,2321,183,72550,0,0,13678,57594,61,272,395,1593,18.6,78.2,0.1,0.4,0.5,2.2
E07000087,FAREHAM,52618,52599,19.4,78.9,3.9,0,0.2,0.4,1.7,0,99.6,0,0,51721,41516,2043,8,94,218,878,19,52388,0,0,10205,41516,8,86,124,660,19.4,78.9,0,0.2,0.2,1.3
E07000010,FENLAND,47578,47557,37.8,55.7,26.5,0.5,1.3,2.1,6.4,0.5,98.5,5.9,0.8,44518,26520,12610,260,616,1011,3039,245,46864,2784,359,17998,26520,260,356,395,2028,37.8,55.7,0.5,0.7,0.8,4.3
N09000006,FERMANAGH AND OMAGH,50255,49396,55.4,13.3,13.3,7.9,13.5,18.8,29.6,5,97,39.9,9.4,34507,6672,6672,3947,6805,9424,14889,2513,48764,20028,4704,27835,6672,3947,2858,2619,5465,55.4,13.3,7.9,5.7,5.2,10.9
S12000047,FIFE,189503,189267,51.8,42.9,15.3,0.2,0.8,1.8,5.1,0.3,98.6,0,0,179648,81391,29071,445,1489,3354,9619,563,186890,0,0,98257,81391,445,1044,1865,6265,51.8,42.9,0.2,0.6,1,3.3
W06000005,FLINTSHIRE,73621,73555,79.1,13.7,9.3,0.3,1,2.3,7,0.5,97.8,32.5,9.2,68375,10120,6822,243,742,1680,5180,335,72020,23940,6808,58255,10120,243,499,938,3500,79.1,13.7,0.3,0.7,1.3,4.8
E07000112,FOLKESTONE AND HYTHE,54141,54112,55.3,37.8,1.9,0.5,1.2,2.5,6.8,0.4,97.9,0,0,50416,20455,1015,284,676,1335,3696,198,52989,0,0,29961,20455,284,392,659,2361,55.3,37.8,0.5,0.7,1.2,4.4
E07000080,FOREST OF DEAN,41363,41333,65.6,12.1,10.3,0.7,3.5,8.7,22.3,2.1,87.6,12.5,5.3,32127,4986,4256,284,1428,3597,9206,882,36253,5187,2197,27141,4986,284,1144,2169,5609,65.6,12.1,0.7,2.8,5.2,13.6
E07000119,FYLDE,36760,36538,60.8,30.8,3.1,0.1,0.8,1.3,7.8,0.6,96.9,7.7,3.3,33653,11315,1130,21,285,465,2885,223,35618,2835,1223,22338,11315,21,264,180,2420,60.8,30.8,0.1,0.7,0.5,6.6
E08000037,GATESHEAD,100128,100007,31.1,64.4,3.4,0,0.3,1.3,4.4,0.2,97.2,0,0,95616,64482,3444,49,281,1276,4391,157,97314,1,0,31134,64482,49,232,995,3115,31.1,64.4,0,0.2,1,3.1
E07000173,GEDLING,54651,54642,11.5,87.4,27.9,0,0.2,0.3,1,0.1,99.8,0,0,54080,47771,15222,22,127,157,562,32,54554,0,0,6309,47771,22,105,30,405,11.5,87.4,0,0.2,0.1,0.7
S12000049,GLASGOW CITY,184499,184223,41.1,54.2,8.1,0,0.1,0.5,4.5,0.1,96,0,0,175918,100046,15020,44,191,909,8305,271,177160,0,0,75872,100046,44,147,718,7396,41.1,54.2,0,0.1,0.4,4
E07000081,GLOUCESTER,59615,59611,14.9,82.8,4.7,0,0.1,0.6,2.4,0,98.2,49.8,2.1,58210,49332,2800,1,70,348,1401,13,58517,29696,1258,8878,49332,1,69,278,1053,14.9,82.8,0,0.1,0.5,1.8
E07000088,GOSPORT,38777,38763,23.4,76.4,0.9,0,0,0,0.2,0,99.9,0,0,38701,29638,356,1,9,9,62,14,38753,0,0,9063,29638,1,8,0,53,23.4,76.4,0,0,0,0.1
E07000109,GRAVESHAM,44992,44981,30.6,65,6.3,0,0.4,0.8,4.3,0.1,98.5,0,0,43025,29245,2829,17,193,355,1956,63,44329,0,0,13780,29245,17,176,162,1601,30.6,65,0,0.4,0.4,3.6
E07000145,GREAT YARMOUTH,48928,48898,46.7,49.5,2.4,0,0.3,0.5,3.8,0.2,99.1,0,0,47062,24229,1160,17,128,267,1836,77,48486,0,0,22833,24229,17,111,139,1569,46.7,49.5,0,0.2,0.3,3.2
E09000011,GREENWICH,124192,124167,22.5,75.4,11.9,0,0.1,0.7,2.1,0,98.2,0,0,121609,93695,14753,0,177,919,2558,22,121971,0,0,27914,93695,0,177,742,1639,22.5,75.4,0,0.1,0.6,1.3
E07000209,GUILDFORD,58187,58185,31.3,64.7,2.6,0,0.2,0.6,4,0.1,99.3,0,0,55844,37654,1504,22,114,366,2341,87,57792,0,0,18190,37654,22,92,252,1975,31.3,64.7,0,0.2,0.4,3.4
W06000002,GWYNEDD,68002,67822,72,15.4,14.5,1.4,3.2,5.6,12.3,2,94.4,11.4,4.2,59436,10444,9894,921,2201,3822,8386,1355,64160,7737,2825,48992,10444,921,1280,1621,4564,72,15.4,1.4,1.9,2.4,6.7
E09000012,HACKNEY,124215,124061,28.1,69.1,10.2,0,0,0.2,2.7,0.1,97.2,0,0,120737,85879,12656,0,0,229,3324,150,120779,0,0,34858,85879,0,0,229,3095,28.1,69.1,0,0,0.2,2.5
E06000006,HALTON,61801,61784,34.6,63,1.4,0,0.1,0.4,2.4,0,99.4,0,0,60290,38931,861,15,75,262,1494,19,61437,8,0,21359,38931,15,60,187,1232,34.6,63,0,0.1,0.3,2
E07000164,HAMBLETON,43915,43857,82.9,4,4,1.6,4.1,6.9,12.9,1.1,97.4,41.3,25.3,38180,1756,1740,690,1803,3026,5677,470,42789,18137,11089,36424,1756,690,1113,1223,2651,82.9,4,1.6,2.5,2.8,6
E09000013,HAMMERSMITH AND FULHAM,92258,92067,41.7,52.3,16,0,0.1,0.2,5.8,0.2,94,0,0,86680,48221,14740,0,66,214,5387,182,86691,0,0,38459,48221,0,66,148,5173,41.7,52.3,0,0.1,0.2,5.6
E07000131,HARBOROUGH,42288,42258,61.4,33.2,11.5,0.3,0.7,1.5,5.3,0.4,98.6,0,0,40025,14047,4863,127,294,633,2233,185,41694,0,0,25978,14047,127,167,339,1600,61.4,33.2,0.3,0.4,0.8,3.8
E09000014,HARINGEY,107841,107801,16,82.2,2.2,0,0.1,0.3,1.7,0,98.4,0,0,105949,88652,2373,0,76,352,1852,40,106083,0,0,17297,88652,0,76,276,1500,16,82.2,0,0.1,0.3,1.4
E07000073,HARLOW,42466,42460,13.3,83.4,1.5,0,0,0.5,3.3,0,96.9,0,0,41059,35411,642,1,11,209,1401,5,41164,0,0,5648,35411,1,10,198,1192,13.3,83.4,0,0,0.5,2.8
E07000165,HARROGATE,77264,77220,38.4,52,3.5,0.9,2.5,3.8,9.6,0.8,97.4,13.1,5.8,69814,40152,2676,719,1946,2912,7406,606,75232,10154,4445,29662,40152,719,1227,966,4494,38.4,52,0.9,1.6,1.3,5.8
E09000015,HARROW,98017,97981,21.3,76,10.6,0,0,0.5,2.7,0.1,97.4,0,0,95368,74503,10378,14,46,505,2613,61,95476,0,0,20865,74503,14,32,459,2108,21.3,76,0,0,0.5,2.2
E07000089,HART,43871,43659,35.6,58.3,5.4,0.1,0.9,1.4,5.7,0.7,98,0,0,41178,25578,2381,26,405,631,2481,302,43007,0,0,15600,25578,26,379,226,1850,35.6,58.3,0.1,0.9,0.5,4.2
E06000001,HARTLEPOOL,47177,47148,12.9,83.1,0.3,0.3,0.6,1.3,3.9,0.1,96.6,1.3,0,45294,39190,132,122,272,619,1854,38,45551,597,4,6104,39190,122,150,347,1235,12.9,83.1,0.3,0.3,0.7,2.6
E07000062,HASTINGS,46036,46024,96.9,0.8,0.8,0,0,0,2.2,0,99.9,0,0,44994,371,371,0,5,10,1030,12,45973,0,0,44623,371,0,5,5,1020,96.9,0.8,0,0,0,2.2
E07000090,HAVANT,57567,57507,15.3,83.8,0.8,0,0,0.1,0.8,0.1,99.6,0,0,57033,48247,458,2,7,82,474,58,57314,0,0,8786,48247,2,5,75,392,15.3,83.8,0,0,0.1,0.7
E09000016,HAVERING,112087,111441,16.5,79.9,3,0.1,0.2,0.4,3,0.7,97.2,0,0,108034,89553,3389,68,177,502,3407,780,108981,0,0,18481,89553,68,109,325,2905,16.5,79.9,0.1,0.1,0.3,2.6
E06000019,"HEREFORDSHIRE, COUNTY OF",89503,89403,70.3,15,13.2,1,3.2,5.9,14.6,1.8,94.2,18.1,6.1,76357,13448,11791,934,2876,5294,13046,1572,84292,16158,5472,62909,13448,934,1942,2418,7752,70.3,15,1,2.2,2.7,8.7
E07000098,HERTSMERE,46008,45999,21.7,75.9,2.7,0,0.2,0.4,2.4,0,98.9,0,0,44915,34909,1242,6,104,194,1084,18,45483,0,0,10006,34909,6,98,90,890,21.7,75.9,0,0.2,0.2,1.9
E07000037,HIGH PEAK,45882,45791,86,4,2.7,0.7,1.9,3,9.8,0.8,98.2,0,0,41288,1839,1216,343,876,1383,4503,375,45055,0,0,39449,1839,343,533,507,3120,86,4,0.7,1.2,1.1,6.8
S12000017,HIGHLAND,114215,112293,78,1.5,1.5,2.3,4.6,8.3,18.8,4,93.1,8.3,1.7,90845,1769,1769,2575,5246,9512,21448,4539,106364,9516,1936,89076,1769,2575,2671,4266,11936,78,1.5,2.3,2.3,3.7,10.5
E09000017,HILLINGDON,120033,119326,13,82.8,4.9,0,0.2,0.7,3.6,0.6,96.2,0,0,115043,99414,5904,44,256,900,4283,720,115525,0,0,15629,99414,44,212,644,3383,13,82.8,0,0.2,0.5,2.8
E07000132,HINCKLEY AND BOSWORTH,54851,54420,36.6,58.5,5.8,0.1,0.9,1.6,4.1,0.9,97.6,0,0,52161,32096,3173,49,519,899,2259,471,53532,0,0,20065,32096,49,470,380,1360,36.6,58.5,0.1,0.9,0.7,2.5
E07000227,HORSHAM,66064,66029,76,16.3,8.3,0.3,1,1.9,7.6,0.6,98.5,0,0,60985,10754,5496,224,670,1227,5044,403,65105,0,0,50231,10754,224,446,557,3817,76,16.3,0.3,0.7,0.8,5.8
E09000018,HOUNSLOW,99649,99477,13.4,84.1,9.7,0,0.1,0.4,2.2,0.2,97.7,0,0,97254,83853,9694,0,126,378,2223,174,97346,0,0,13401,83853,0,126,252,1845,13.4,84.1,0,0.1,0.3,1.9
E07000011,HUNTINGDONSHIRE,82078,81712,44.7,50.5,4.2,0.3,0.9,1.6,4.4,0.3,98.7,0.4,0,78130,41464,3470,252,715,1302,3582,221,81047,316,0,36666,41464,252,463,587,2280,44.7,50.5,0.3,0.6,0.7,2.8
E07000120,HYNDBURN,40968,40914,40.6,56.9,0.6,0,0.1,0.2,2.4,0.1,99.1,43.7,23.4,39947,23320,233,14,42,90,967,46,40588,17915,9591,16627,23320,14,28,48,877,40.6,56.9,0,0.1,0.1,2.1
S12000018,INVERCLYDE,41953,41916,25.1,72,8.6,0.1,0.3,0.6,2.9,0.2,98.5,0,0,40717,30199,3624,41,124,259,1199,71,41314,0,0,10518,30199,41,83,135,940,25.1,72,0.1,0.2,0.3,2.2
E07000202,IPSWICH,64916,64887,20,78.8,1.7,0,0,0.2,1.1,0,99.1,0,0,64153,51144,1130,0,26,109,734,23,64310,0,0,13009,51144,0,26,83,625,20,78.8,0,0,0.1,1
W06000001,ISLE OF ANGLESEY,36935,36825,73.1,15.7,15.7,0.7,2,3.5,10.9,1.4,96.3,22.5,7,32816,5813,5813,260,754,1297,4009,510,35578,8311,2569,27003,5813,260,494,543,2712,73.1,15.7,0.7,1.3,1.5,7.3
E06000046,ISLE OF WIGHT,78218,78060,93,0.9,17.7,0.3,0.7,1.3,5.9,0.4,99.6,0,0,73416,665,13838,228,566,1026,4644,315,77867,0,0,72751,665,228,338,460,3618,93,0.9,0.3,0.4,0.6,4.6
E06000053,ISLES OF SCILLY,1681,1678,94.3,0,0,0,0,0.2,5.5,0.2,99.8,0,0,1586,0,0,0,0,4,92,3,1678,0,0,1586,0,0,0,4,88,94.3,0,0,0,0.2,5.2
E09000019,ISLINGTON,121461,121430,18.5,75.7,8.1,0,0,0,5.7,0,94.3,0,0,114532,92004,9824,0,0,21,6898,26,114562,0,0,22528,92004,0,0,21,6877,18.5,75.7,0,0,0,5.7
E09000020,KENSINGTON AND CHELSEA,99625,99601,16.5,78.3,5,0,0,0.1,5.2,0,94.8,0,0,94420,77989,4942,0,0,52,5181,24,94421,0,0,16431,77989,0,0,52,5129,16.5,78.3,0,0,0.1,5.1
E07000153,KETTERING,48617,48276,43.7,52.4,6.8,0.1,0.5,1,3.2,0.9,96.9,0.1,0,46714,25457,3291,41,234,497,1562,441,47106,34,0,21257,25457,41,193,263,1065,43.7,52.4,0.1,0.4,0.5,2.2
E07000146,KING'S LYNN AND WEST NORFOLK,78768,78575,84.9,5.2,2.4,0.5,1.5,3.1,9.7,1,97.7,3,0.4,70960,4077,1873,407,1168,2409,7615,821,76930,2399,325,66883,4077,407,761,1241,5206,84.9,5.2,0.5,1,1.6,6.6
E06000010,"KINGSTON UPON HULL, CITY OF",127335,125946,1.1,97,97,0,0,0.2,0.8,0,98.1,21.3,12,124878,123503,123503,5,34,291,1068,32,124878,27122,15301,1375,123503,5,29,257,777,1.1,97,0,0,0.2,0.6
E09000021,KINGSTON UPON THAMES,70662,70608,11,86,2,0,0.1,0.2,2.9,0.1,97.8,0,0,68565,60776,1422,9,46,132,2043,69,69127,0,0,7789,60776,9,37,86,1911,11,86,0,0.1,0.1,2.7
E08000034,KIRKLEES,195742,195708,33.4,63.2,8.9,0,0.3,0.8,3.4,0,98.6,0.1,0,188971,123691,17378,82,532,1498,6737,64,192984,165,0,65280,123691,82,450,966,5239,33.4,63.2,0,0.2,0.5,2.7
E08000011,KNOWSLEY,72105,72093,26.8,71.9,3.9,0,0.2,0.3,1.2,0,99.6,3.3,0,71201,51853,2789,17,133,204,892,27,71835,2391,0,19348,51853,17,116,71,688,26.8,71.9,0,0.2,0.1,1
E09000022,LAMBETH,155877,155636,28.2,66.5,8.6,0,0,0,5.1,0.2,94.9,0,0,147688,103698,13411,0,0,3,7948,235,147995,0,0,43990,103698,0,0,3,7945,28.2,66.5,0,0,0,5.1
E07000121,LANCASTER,67717,67703,50.7,47.1,10.4,0.2,0.3,0.6,2.1,0.1,99.6,0.5,0,66288,31925,7044,140,224,417,1415,58,67468,348,10,34363,31925,140,84,193,998,50.7,47.1,0.2,0.1,0.3,1.5
E08000035,LEEDS,373895,373809,19.1,77,27.2,0.1,0.3,0.7,3.9,0.1,97.1,4.8,0.6,359355,287982,101850,194,1241,2444,14454,382,363190,17790,2340,71373,287982,194,1047,1203,12010,19.1,77,0.1,0.3,0.3,3.2
E06000016,LEICESTER,143894,143852,14.3,84.8,6,0,0,0.2,0.8,0,99.3,0,0,142663,122078,8645,2,30,273,1189,37,142906,0,0,20585,122078,2,28,243,916,14.3,84.8,0,0,0.2,0.6
E07000063,LEWES,47129,47119,78.1,18.1,18.1,0.1,0.3,0.6,3.8,0.1,99.8,0,0,45326,8538,8528,50,146,284,1793,70,47043,0,0,36788,8538,50,96,138,1509,78.1,18.1,0.1,0.2,0.3,3.2
E09000023,LEWISHAM,137412,137362,31.9,64.2,13.7,0,0,0.2,3.9,0,96.3,0,0,132000,88221,18802,0,0,254,5362,43,132300,0,0,43779,88221,0,0,254,5108,31.9,64.2,0,0,0.2,3.7
E07000194,LICHFIELD,48391,48375,32.1,63.4,4.8,0.4,0.7,1.3,4.4,0.1,99.6,0,0,46232,30680,2323,170,336,650,2143,51,48193,0,0,15552,30680,170,166,314,1493,32.1,63.4,0.4,0.3,0.6,3.1
E07000138,LINCOLN,48101,48067,18.4,79.9,0.5,0,0.1,0.5,1.7,0,98.5,24,20.8,47265,38410,217,14,30,251,802,24,47386,11527,10017,8855,38410,14,16,221,551,18.4,79.9,0,0,0.5,1.1
N09000007,LISBURN AND CASTLEREAGH,60737,60312,29.7,62.7,26.8,0.4,1.4,2.4,6.9,1.2,98.4,0,0,56098,38054,16290,213,857,1468,4214,717,59772,0,0,18044,38054,213,644,611,2746,29.7,62.7,0.4,1.1,1,4.5
E08000012,LIVERPOOL,241635,241532,20.9,73.9,25.1,0,0,0.2,5.1,0,95.1,0,0,229089,178478,60674,3,42,578,12443,105,229903,119,0,50611,178478,3,39,536,11865,20.9,73.9,0,0,0.2,4.9
E06000032,LUTON,87108,87082,8,91.3,3.5,0,0.2,0.2,0.7,0,99.3,0,0,86442,79488,3066,7,168,207,640,22,86503,0,0,6954,79488,7,161,39,433,8,91.3,0,0.2,0,0.5
E07000110,MAIDSTONE,76545,76480,42.4,49.3,4.6,0.5,1.6,2.8,8.2,0.6,97.5,0,0,70208,37773,3520,372,1211,2174,6272,497,74634,0,0,32435,37773,372,839,963,4098,42.4,49.3,0.5,1.1,1.3,5.4
E07000074,MALDON,29617,29565,84.8,5.8,5.8,0.3,1.2,2.5,9.2,0.7,98.8,0,0,26842,1715,1715,102,363,746,2723,221,29259,0,0,25127,1715,102,261,383,1977,84.8,5.8,0.3,0.9,1.3,6.7
E07000235,MALVERN HILLS,37973,37936,76.2,9.2,5.4,0.7,3,6,14.5,1.1,96.2,33.4,15.2,32445,3498,2041,279,1122,2286,5491,407,36512,12678,5780,28947,3498,279,843,1164,3205,76.2,9.2,0.7,2.2,3.1,8.4
E08000003,MANCHESTER,246046,245993,30.9,63.3,13.6,0.1,0.2,1.1,5.8,0,94.7,2.1,0.6,231623,155639,33489,164,469,2754,14370,52,232886,5104,1460,75984,155639,164,305,2285,11616,30.9,63.3,0.1,0.1,0.9,4.7
E07000174,MANSFIELD,52429,52423,20.2,78.4,0.9,0,0.1,0.2,1.4,0,99.7,0,0,51677,41094,487,5,38,86,746,2,52248,0,0,10583,41094,5,33,48,660,20.2,78.4,0,0.1,0.1,1.3
E06000035,MEDWAY,120747,120695,20.2,77.1,0.7,0,0.3,0.7,2.7,0.1,98.9,0,0,117446,93100,843,31,310,826,3249,101,119366,0,0,24346,93100,31,279,516,2423,20.2,77.1,0,0.2,0.4,2
E07000133,MELTON,24425,24375,47.9,45.6,1.2,0.8,1.9,3.1,6.2,0.9,97.2,2.4,1.3,22860,11150,304,193,472,767,1515,219,23729,592,328,11710,11150,193,279,295,748,47.9,45.6,0.8,1.1,1.2,3.1
E07000187,MENDIP,55564,55498,57.8,25.9,3.4,0.7,2.7,6.2,16.2,1.4,93.7,0.2,0.2,46500,14409,1878,376,1504,3437,8998,778,52067,115,115,32091,14409,376,1128,1933,5561,57.8,25.9,0.7,2,3.5,10
W06000024,MERTHYR TYDFIL,28533,28518,94.3,2.4,2.4,0.1,0.3,0.4,3.3,0.1,99.7,17.2,7.3,27590,672,672,41,72,109,928,19,28461,4913,2086,26918,672,41,31,37,819,94.3,2.4,0.1,0.1,0.1,2.9
E09000024,MERTON,89391,89384,14.9,83.4,8.6,0,0,0.2,1.7,0,98.4,0,0,87903,74584,7691,1,37,197,1481,6,87940,0,0,13319,74584,1,36,160,1284,14.9,83.4,0,0,0.2,1.4
N09000008,MID AND EAST ANTRIM,61618,61018,55,33.9,33.9,1.9,3.4,4.8,10.2,2,97.8,0,0,54752,20889,20888,1149,2115,2963,6266,1206,60264,0,0,33863,20889,1149,966,848,3303,55,33.9,1.9,1.6,1.4,5.4
E07000042,MID DEVON,36967,36873,73.6,3.8,3.8,1.9,5.7,10.7,22.4,2.9,91.5,7.7,3.7,28606,1389,1387,692,2124,3937,8267,1059,33811,2840,1386,27217,1389,692,1432,1813,4330,73.6,3.8,1.9,3.9,4.9,11.7
E07000203,MID SUFFOLK,48438,48387,80.2,8.5,7.8,0.7,1.6,3.1,11.2,1.2,98,0,0,42970,4120,3754,327,758,1516,5417,571,47452,0,0,38850,4120,327,431,758,3901,80.2,8.5,0.7,0.9,1.6,8.1
E07000228,MID SUSSEX,69219,69139,78.8,15.6,13.1,0.1,0.3,0.9,5.5,0.4,99.6,0,0,65324,10800,9094,65,232,609,3815,268,68932,0,0,54524,10800,65,167,377,3206,78.8,15.6,0.1,0.2,0.5,4.6
N09000009,MID ULSTER,55454,54697,63.9,13,13,3.5,7,10.6,21.8,5,97.5,4.5,1.4,42623,7201,7201,1963,3869,5869,12074,2760,54072,2496,775,35422,7201,1963,1906,2000,6205,63.9,13,3.5,3.4,3.6,11.2
E06000002,MIDDLESBROUGH,67284,67250,8.5,87.8,0.9,0.1,0.6,1.1,3.6,0,96.7,0.9,0,64843,59095,578,74,412,764,2407,6,65033,614,23,5748,59095,74,338,352,1643,8.5,87.8,0.1,0.5,0.5,2.4
S12000019,MIDLOTHIAN,40073,39864,67,25.4,25.4,0.6,1.5,2.8,7.1,1,97.4,3.8,3.8,37028,10192,10192,248,594,1111,2836,411,39030,1511,1511,26836,10192,248,346,517,1725,67,25.4,0.6,0.9,1.3,4.3
E06000042,MILTON KEYNES,120466,120427,49.4,47.4,43.9,0.1,0.4,1,3.2,0.1,98.8,0,0,116598,57081,52922,103,537,1219,3829,123,119067,0,0,59517,57081,103,434,682,2610,49.4,47.4,0.1,0.4,0.6,2.2
E07000210,MOLE VALLEY,39616,39604,39.2,55.6,5.6,0.1,0.3,0.8,5.2,0.3,99.5,0,0,37555,22015,2217,28,108,312,2049,121,39424,0,0,15540,22015,28,80,204,1737,39.2,55.6,0.1,0.2,0.5,4.4
W06000021,MONMOUTHSHIRE,45316,45096,72.3,12.8,7,1.4,3.3,5.9,14.3,2.3,95.8,1,0,38594,5814,3171,617,1507,2695,6502,1024,43431,439,1,32780,5814,617,890,1188,3807,72.3,12.8,1.4,2,2.6,8.4
S12000020,MORAY,49033,48737,82.4,1,1,1.6,4.5,7.2,16,3.3,95.1,0,0,40883,503,503,794,2224,3522,7854,1618,46609,0,0,40380,503,794,1430,1298,4332,82.4,1,1.6,2.9,2.6,8.8
S12000013,NA H-EILEANAN SIAR,16312,14881,69.7,2.6,2.6,2.8,4.7,6.6,19,5.9,86.3,0,0,11785,419,419,457,771,1078,3096,962,14081,0,0,11366,419,457,314,307,2018,69.7,2.6,2.8,1.9,1.9,12.4
W06000012,NEATH PORT TALBOT,68828,68812,38.9,57.9,2.7,0.1,0.3,0.5,3.1,0.1,99.2,15.3,7.5,66647,39847,1846,100,211,358,2165,101,68274,10502,5156,26800,39847,100,111,147,1807,38.9,57.9,0.1,0.2,0.2,2.6
E07000091,NEW FOREST,86938,86877,71.8,20.4,9.2,0.6,1.2,2,7.7,1,98.8,0,0,80164,17706,8036,509,1024,1701,6713,855,85937,0,0,62458,17706,509,515,677,5012,71.8,20.4,0.6,0.6,0.8,5.8
E07000175,NEWARK AND SHERWOOD,58422,58359,43.9,51.4,11.1,0.3,0.9,1.4,4.6,0.3,98.8,0,0,55664,30035,6483,172,543,809,2695,171,57703,13,0,25629,30035,172,371,266,1886,43.9,51.4,0.3,0.6,0.5,3.2
E08000021,NEWCASTLE UPON TYNE,144947,144834,36.6,58.6,4.9,0,0.1,0.3,4.8,0.1,95.9,0,0,137935,84870,7162,13,86,423,6899,109,139034,0,0,53065,84870,13,73,337,6476,36.6,58.6,0,0.1,0.2,4.5
E07000195,NEWCASTLE-UNDER-LYME,60506,60489,37.5,59,9.5,0,0.3,0.8,3.6,0.1,99.1,1.8,0.4,58340,35680,5729,24,188,457,2149,84,59975,1067,237,22660,35680,24,164,269,1692,37.5,59,0,0.3,0.4,2.8
E09000025,NEWHAM,126639,126613,17.8,79.9,16.9,0,0.1,0.7,2.3,0,97.7,0,0,123727,101214,21342,4,72,927,2886,31,123743,0,0,22513,101214,4,68,855,1959,17.8,79.9,0,0.1,0.7,1.5
W06000022,NEWPORT,72329,72306,30.4,66.7,4.2,0.1,0.4,0.9,2.9,0.1,98.1,38.3,8.3,70232,48249,3036,73,272,622,2074,78,70958,27669,5975,21983,48249,73,199,350,1452,30.4,66.7,0.1,0.3,0.5,2
N09000010,"NEWRY, MOURNE AND DOWN",70729,69322,75,6.7,6.7,2.8,5.3,7.7,16.3,4.2,97.3,5,0.6,57826,4764,4764,2007,3764,5443,11496,2982,68800,3504,411,53062,4764,2007,1757,1679,6053,75,6.7,2.8,2.5,2.4,8.6
S12000021,NORTH AYRSHIRE,71685,71648,64.4,28.8,8.5,0.4,0.9,2,6.7,0.4,98.6,0,0,66822,20632,6105,314,679,1455,4826,256,70706,0,0,46190,20632,314,365,776,3371,64.4,28.8,0.4,0.5,1.1,4.7
E07000043,NORTH DEVON,50527,50443,82.7,2.7,2.7,1.3,3.7,7.5,14.4,2.2,93.5,16,4.3,43157,1371,1371,661,1856,3769,7286,1109,47249,8071,2172,41786,1371,661,1195,1913,3517,82.7,2.7,1.3,2.4,3.8,7
E07000038,NORTH EAST DERBYSHIRE,48092,48080,73.8,15.5,13.9,0.4,1.7,2.6,10.6,0.2,98.5,0,0,42989,7478,6690,201,828,1255,5091,73,47370,0,0,35511,7478,201,627,427,3836,73.8,15.5,0.4,1.3,0.9,8
E06000012,NORTH EAST LINCOLNSHIRE,73615,73560,9.2,87.8,0.5,0.1,0.8,1.3,2.9,0.2,97.7,26,19.7,71408,64628,391,69,606,921,2152,177,71958,19110,14523,6780,64628,69,537,315,1231,9.2,87.8,0.1,0.7,0.4,1.7
E07000099,NORTH HERTFORDSHIRE,60559,60529,26.2,69,1.4,0.1,0.5,1.3,4.7,0.3,97.8,0,0,57680,41787,856,72,303,801,2849,199,59220,0,0,15893,41787,72,231,498,2048,26.2,69,0.1,0.4,0.8,3.4
E07000139,NORTH KESTEVEN,54013,53986,60.3,32.7,2.6,0.7,1.5,2.5,6.9,0.5,97.8,4.9,3.1,50270,17679,1426,400,830,1324,3716,253,52847,2651,1673,32591,17679,400,430,494,2392,60.3,32.7,0.7,0.8,0.9,4.4
S12000050,NORTH LANARKSHIRE,163631,163603,25.4,72.2,7.2,0.1,0.4,0.7,2.3,0.1,99,0,0,159810,118196,11814,98,640,1151,3793,194,161986,0,0,41614,118196,98,542,511,2642,25.4,72.2,0.1,0.3,0.3,1.6
E06000013,NORTH LINCOLNSHIRE,80358,80234,53.6,39.7,1.4,0.7,1.4,2.1,6.5,0.4,97.2,52.1,43.9,75013,31934,1158,538,1096,1719,5221,324,78115,41855,35271,43079,31934,538,558,623,3502,53.6,39.7,0.7,0.7,0.8,4.4
E07000147,NORTH NORFOLK,60013,59952,85.4,2.4,2.4,0.6,2.5,4.3,12.1,2.6,96.4,0.1,0.1,52666,1426,1420,361,1527,2583,7286,1562,57856,61,61,51240,1426,361,1166,1056,4703,85.4,2.4,0.6,1.9,1.8,7.8
E06000024,NORTH SOMERSET,103145,102760,60.1,30,6,0.3,1,2.4,9.6,0.5,95.7,0,0,92885,30927,6143,308,1025,2494,9875,556,98758,0,0,61958,30927,308,717,1469,7381,60.1,30,0.3,0.7,1.4,7.2
E08000022,NORTH TYNESIDE,101805,101590,36.9,61,0.8,0,0.2,0.6,1.8,0.3,99,0,0,99714,62119,836,24,197,565,1876,267,100787,0,0,37595,62119,24,173,368,1311,36.9,61,0,0.2,0.4,1.3
E07000218,NORTH WARWICKSHIRE,30006,29973,72.2,22.3,7.8,0.4,1.1,1.7,5.4,0.2,99.3,0,0,28353,6698,2338,112,337,511,1620,58,29803,0,0,21655,6698,112,225,174,1109,72.2,22.3,0.4,0.7,0.6,3.7
E07000134,NORTH WEST LEICESTERSHIRE,47713,47680,29.9,65.3,3.7,0.1,0.8,1.4,4.7,0.3,99,0,0,45433,31160,1772,65,398,674,2247,164,47222,0,0,14273,31160,65,333,276,1573,29.9,65.3,0.1,0.7,0.6,3.3
E07000154,NORTHAMPTON,106786,104653,24.9,71.5,3.9,0,0.3,0.6,1.6,1.7,96.6,1.2,0,102939,76359,4128,16,372,605,1714,1832,103156,1258,5,26580,76359,16,356,233,1109,24.9,71.5,0,0.3,0.2,1
E06000057,NORTHUMBERLAND,155221,154983,85.5,6.6,3.3,0.9,1.9,2.9,7.7,0.8,98.4,5.5,0.6,143046,10261,5134,1455,2932,4451,11937,1261,152778,8488,891,132785,10261,1455,1477,1519,7486,85.5,6.6,0.9,1,1,4.8
E07000148,NORWICH,59430,58947,16.7,80.9,0.2,0,0,0.5,1.6,0,97.8,0,0,58005,48093,100,0,10,289,942,22,58145,0,0,9912,48093,0,10,279,653,16.7,80.9,0,0,0.5,1.1
E06000018,NOTTINGHAM,148661,148620,9.1,88,6.7,0,0.2,0.4,2.9,0,97.2,0,0,144249,130754,10009,12,321,607,4371,41,144501,0,0,13495,130754,12,309,286,3764,9.1,88,0,0.2,0.2,2.5
E07000219,NUNEATON AND BEDWORTH,60600,60596,26.1,72.8,3,0,0.1,0.2,1.1,0,99.6,0,0,59913,44096,1817,9,79,131,683,10,60358,0,0,15817,44096,9,70,52,552,26.1,72.8,0,0.1,0.1,0.9
E07000135,OADBY AND WIGSTON,25366,25323,22.7,76,2.2,0,0,0.1,1.2,0.2,99.2,0,0,25022,19270,570,3,8,25,301,41,25153,0,0,5752,19270,3,5,17,276,22.7,76,0,0,0.1,1.1
E08000004,OLDHAM,98507,98441,27.8,70.3,8.3,0.1,0.2,0.4,1.9,0.1,99.6,0,0,96616,69214,8169,69,198,368,1825,64,98155,0,0,27402,69214,69,129,170,1457,27.8,70.3,0.1,0.1,0.2,1.5
S12000023,ORKNEY ISLANDS,12729,12178,62,0.4,0.4,4.4,10,21.4,33.3,7.1,75.5,0,0,7938,46,46,555,1274,2726,4240,906,9605,0,0,7892,46,555,719,1452,1514,62,0.4,4.4,5.6,11.4,11.9
E07000178,OXFORD,66598,66518,19.7,77.7,1.8,0,0,0.4,2.5,0.1,97.5,0,0,64842,51732,1192,0,30,267,1676,53,64950,0,0,13110,51732,0,30,237,1409,19.7,77.7,0,0,0.4,2.1
W06000009,PEMBROKESHIRE,65385,65303,81.7,5.2,5.2,1.8,4.1,6.7,12.9,2.2,95.3,5,2.1,56864,3419,3414,1149,2686,4384,8439,1417,62280,3262,1350,53445,3419,1149,1537,1698,4055,81.7,5.2,1.8,2.4,2.6,6.2
E07000122,PENDLE,43503,43482,63.2,33.2,1.4,0.3,0.6,1,3.6,0.1,99.3,57.5,21.4,41917,14435,619,121,279,433,1565,52,43177,25020,9290,27482,14435,121,158,154,1132,63.2,33.2,0.3,0.4,0.4,2.6
S12000048,PERTH AND KINROSS,77903,77529,52.3,32,1.5,1.7,4.2,7.6,15.3,2.1,94.6,0,0,65621,24899,1204,1320,3309,5927,11908,1627,73733,0,0,40722,24899,1320,1989,2618,5981,52.3,32,1.7,2.6,3.4,7.7
E06000031,PETERBOROUGH,91043,90989,25,72.4,25.4,0.1,0.3,0.6,2.6,0.1,98.7,0,0,88642,65903,23103,89,308,542,2347,119,89834,0,0,22739,65903,89,219,234,1805,25,72.4,0.1,0.2,0.3,2
E06000026,PLYMOUTH,124912,124873,12.7,84.1,1.1,0,0.2,0.9,3.2,0,97.2,19.2,2.9,120914,105102,1329,2,228,1123,3959,42,121422,24041,3629,15812,105102,2,226,895,2836,12.7,84.1,0,0.2,0.7,2.3
E06000044,PORTSMOUTH,96281,95881,9.5,86.8,4.3,0,0.3,0.7,3.3,0.4,96.5,0,0,92713,83601,4161,1,293,701,3168,401,92870,0,0,9112,83601,1,292,408,2467,9.5,86.8,0,0.3,0.4,2.6
W06000023,POWYS,68967,68097,61.3,17,17,3.3,6.9,11.6,20.4,5.5,89.4,10.1,2.1,54002,11714,11712,2303,4786,7983,14095,3804,61665,6988,1459,42288,11714,2303,2483,3197,6112,61.3,17,3.3,3.6,4.6,8.9
E07000123,PRESTON,68010,67958,33.5,63.8,3.9,0,0.1,0.6,2.6,0.1,98.7,61.4,51.7,66204,43398,2659,28,65,375,1754,82,67092,41790,35130,22806,43398,28,37,310,1379,33.5,63.8,0,0.1,0.5,2
E06000038,READING,76271,76218,25.9,72.5,9.7,0,0.1,0.2,1.6,0.1,98.6,0,0,75005,55287,7413,4,94,165,1213,53,75201,0,0,19718,55287,4,90,71,1048,25.9,72.5,0,0.1,0.1,1.4
E09000026,REDBRIDGE,109742,109722,14.5,83.9,9,0,0.1,0.2,1.6,0,98.6,0,0,107977,92043,9865,14,68,180,1745,25,108241,0,0,15934,92043,14,54,112,1565,14.5,83.9,0,0,0.1,1.4
E06000003,REDCAR AND CLEVELAND,67775,67763,11.7,84.5,0.6,0.3,0.8,1.6,3.8,0.3,97.7,0.4,0,65204,57256,430,187,530,1105,2559,218,66232,275,0,7948,57256,187,343,575,1454,11.7,84.5,0.3,0.5,0.8,2.1
E07000236,REDDITCH,39456,39433,20.6,77.5,1.7,0,0,0.1,1.9,0.1,98.8,2.6,1.4,38679,30560,688,4,16,43,754,21,38988,1029,545,8119,30560,4,12,27,711,20.6,77.5,0,0,0.1,1.8
E07000211,REIGATE AND BANSTEAD,63672,63655,31.2,66.3,3,0,0.1,0.3,2.4,0.1,99.7,0,0,62097,42240,1924,15,84,181,1558,51,63510,0,0,19857,42240,15,69,97,1377,31.2,66.3,0,0.1,0.2,2.2
S12000038,RENFREWSHIRE,94060,94033,24.2,72.5,9.4,0.1,0.3,0.7,3.3,0.1,98.4,0,0,90959,68199,8795,91,296,639,3074,57,92517,0,0,22760,68199,91,205,343,2435,24.2,72.5,0.1,0.2,0.4,2.6
W06000016,RHONDDA CYNON TAF,118673,118518,84,13.1,3.3,0,0.1,0.5,2.8,0.2,99.1,21.3,10.9,115250,15580,3972,50,105,554,3268,260,117640,25333,12986,99670,15580,50,55,449,2714,84,13.1,0,0,0.4,2.3
E07000124,RIBBLE VALLEY,29553,29531,78.5,10.5,7.7,0.8,2.5,4.5,10.9,0.5,98.7,61.6,20.9,26307,3114,2289,230,749,1324,3224,161,29158,18194,6187,23193,3114,230,519,575,1900,78.5,10.5,0.8,1.8,1.9,6.4
E09000027,RICHMOND UPON THAMES,88918,88842,18.9,79.2,13.2,0,0,0.3,1.8,0.1,98.3,0,0,87257,70410,11729,1,18,271,1585,61,87411,0,0,16847,70410,1,17,253,1314,18.9,79.2,0,0,0.3,1.5
E07000166,RICHMONDSHIRE,25445,25357,72.3,9.4,2.7,2.4,5.1,9.1,18,3,95.5,35,19.7,20778,2388,694,621,1301,2315,4579,776,24305,8909,5011,18390,2388,621,680,1014,2264,72.3,9.4,2.4,2.7,4,8.9
E08000005,ROCHDALE,100657,100557,39.1,58.6,8.6,0,0.1,0.3,2.2,0.1,99.4,0,0,98345,59026,8686,22,92,330,2212,131,100009,0,0,39319,59026,22,70,238,1882,39.1,58.6,0,0.1,0.2,1.9
E07000075,ROCHFORD,37522,37440,86.4,8,4.2,0,0.2,0.8,5.4,0.2,98.8,0,0,35413,2995,1580,8,65,309,2027,75,37083,0,0,32418,2995,8,57,244,1718,86.4,8,0,0.2,0.7,4.6
E07000125,ROSSENDALE,34677,34654,52.8,42.2,0.4,0.1,0.7,1,4.9,0.2,99.2,5.7,5.5,32953,14633,127,24,249,332,1701,61,34412,1963,1899,18320,14633,24,225,83,1369,52.8,42.2,0.1,0.6,0.2,3.9
E07000064,ROTHER,49123,49007,88.5,3.5,3.5,0.1,0.4,1.5,7.7,0.4,99.4,0,0,45205,1724,1724,63,211,715,3802,212,48833,0,0,43481,1724,63,148,504,3087,88.5,3.5,0.1,0.3,1,6.3
E08000018,ROTHERHAM,123920,123762,39.7,58.2,8.2,0,0.2,0.5,2,0.2,99.2,0.4,0.2,121243,72075,10109,56,287,647,2519,203,122987,525,214,49168,72075,56,231,360,1872,39.7,58.2,0,0.2,0.3,1.5
E07000220,RUGBY,50405,50362,42.5,52.3,5.5,0.3,0.6,1.4,5.1,0.2,97.4,0,0,47805,26382,2771,176,326,728,2557,85,49079,0,0,21423,26382,176,150,402,1829,42.5,52.3,0.3,0.3,0.8,3.6
E07000212,RUNNYMEDE,38301,38281,29.9,67.3,3.3,0,0.1,0.6,2.7,0.1,99.2,0,0,37235,25767,1252,0,20,243,1046,24,37979,0,0,11468,25767,0,20,223,803,29.9,67.3,0,0.1,0.6,2.1
E07000176,RUSHCLIFFE,53715,53676,28.7,67.9,4.1,0.2,0.4,0.9,3.3,0.2,99.4,1.3,0.1,51906,36472,2226,87,227,495,1770,91,53419,716,58,15434,36472,87,140,268,1275,28.7,67.9,0.2,0.3,0.5,2.4
E07000092,RUSHMOOR,42340,42320,16.8,80.7,3.1,0.1,0.8,1.4,2.5,0.1,97.7,0,0,41258,34158,1328,41,323,579,1062,54,41372,0,0,7100,34158,41,282,256,483,16.8,80.7,0.1,0.7,0.6,1.1
E06000017,RUTLAND,18486,18474,81.4,10,10,0.4,0.8,1.2,8.5,0.2,98.9,0,0,16900,1852,1852,82,142,213,1574,37,18281,0,0,15048,1852,82,60,71,1361,81.4,10,0.4,0.3,0.4,7.4
E07000167,RYEDALE,30033,29774,75.6,5.8,5.8,3.5,6.2,9.2,17.7,4.1,94.3,22.2,12.6,24467,1756,1756,1044,1863,2767,5307,1220,28333,6673,3771,22711,1756,1044,819,904,2540,75.6,5.8,3.5,2.7,3,8.5
E08000006,SALFORD,126765,126727,16.5,79.2,46.9,0,0.3,1.7,4.2,0,96,1.8,0,121344,100457,59405,13,368,2165,5383,41,121667,2233,0,20887,100457,13,355,1797,3218,16.5,79.2,0,0.3,1.4,2.5
E08000028,SANDWELL,141353,141313,28.5,70.8,2.6,0,0,0.2,0.7,0,99.4,0,0,140359,100097,3617,4,21,350,954,36,140573,0,0,40262,100097,4,17,329,604,28.5,70.8,0,0,0.2,0.4
E07000168,SCARBOROUGH,62964,62923,90.5,1.7,1.7,0.6,1.4,2.1,7.7,0.9,96.8,4,0,58059,1047,1044,400,870,1321,4864,566,60972,2515,24,57012,1047,400,470,451,3543,90.5,1.7,0.6,0.7,0.7,5.6
S12000026,SCOTTISH BORDERS,61212,60745,80.2,4.7,3.9,1.7,4.5,8.1,14.4,3.3,94.9,14.6,0.6,51959,2865,2362,1058,2746,4960,8786,2032,58096,8945,382,49094,2865,1058,1688,2214,3826,80.2,4.7,1.7,2.8,3.6,6.3
E07000188,SEDGEMOOR,58915,58879,79.4,11.3,4.2,0.8,1.9,3.4,9.2,0.8,96.8,0,0,53465,6674,2487,480,1123,1974,5414,448,57040,0,0,46791,6674,480,643,851,3440,79.4,11.3,0.8,1.1,1.4,5.8
E08000014,SEFTON,134809,134678,35.6,62.4,2.1,0,0.1,0.3,1.8,0.1,99.4,0.2,0,132218,84177,2861,46,183,364,2460,144,134019,219,0,48041,84177,46,137,181,2096,35.6,62.4,0,0.1,0.1,1.6
E07000169,SELBY,42424,42371,78.9,9.4,9.4,0.9,1.9,2.9,11.6,0.5,96.6,15,13.9,37446,3975,3969,398,809,1231,4925,233,40999,6369,5895,33471,3975,398,411,422,3694,78.9,9.4,0.9,1,1,8.7
E07000111,SEVENOAKS,53062,53043,64.7,26.3,2.4,0.2,0.6,1.4,8.9,0.3,99.4,0,0,48321,13976,1269,132,315,760,4722,175,52724,0,0,34345,13976,132,183,445,3962,64.7,26.3,0.2,0.3,0.8,7.5
E08000019,SHEFFIELD,269643,269583,49.6,43.9,2.4,0,0.1,0.6,6.5,0,95.1,0,0,252090,118475,6559,72,249,1626,17493,102,256336,0,0,133615,118475,72,177,1377,15867,49.6,43.9,0,0.1,0.5,5.9
S12000027,SHETLAND ISLANDS,10996,10710,68,0.5,0.5,3.3,7.9,17.7,28.9,6.1,83.5,0,0,7528,52,52,363,864,1942,3182,675,9187,0,0,7476,52,363,501,1078,1240,68,0.5,3.3,4.6,9.8,11.3
E06000051,SHROPSHIRE,152123,151735,74,11.7,4.8,1,3,5.8,14.1,1.1,95.2,41.8,15.9,130355,17800,7275,1478,4568,8806,21380,1738,144863,63577,24124,112555,17800,1478,3090,4238,12574,74,11.7,1,2,2.8,8.3
E06000039,SLOUGH,57463,57399,14.7,84,5,0,0.1,0.3,1.2,0.1,99,0,0,56724,48284,2867,25,63,156,675,59,56876,0,0,8440,48284,25,38,93,519,14.7,84,0,0.1,0.2,0.9
E08000029,SOLIHULL,96643,96607,22.2,74.9,11.7,0,0.3,1.1,2.9,0,98.1,0,0,93827,72373,11321,28,310,1039,2780,36,94813,0,0,21454,72373,28,282,729,1741,22.2,74.9,0,0.3,0.8,1.8
E07000246,SOMERSET WEST AND TAUNTON,77021,76899,77.2,10.9,3.7,1,2.8,5.2,11.7,1.7,95.6,3.2,1.4,67859,8399,2814,738,2128,4020,9040,1341,73667,2456,1065,59460,8399,738,1390,1892,5020,77.2,10.9,1,1.8,2.5,6.5
S12000028,SOUTH AYRSHIRE,58847,58767,41.1,52.4,0.9,0.4,1.3,2.7,6.3,1,98.2,0,0,55035,30863,541,248,751,1601,3732,586,57777,0,0,24172,30863,248,503,850,2131,41.1,52.4,0.4,0.9,1.4,3.6
E07000006,SOUTH BUCKS,31200,31197,52.9,36.4,12.9,0.1,0.6,2.6,10.7,0.4,97.1,0,0,27870,11360,4033,24,192,808,3327,131,30291,0,0,16510,11360,24,168,616,2519,52.9,36.4,0.1,0.5,2,8.1
E07000012,SOUTH CAMBRIDGESHIRE,69999,69968,45.2,50,13,0.2,0.5,1.3,4.8,0.2,98.8,0.8,0.5,66639,35013,9121,112,337,892,3329,152,69163,547,343,31626,35013,112,225,555,2437,45.2,50,0.2,0.3,0.8,3.5
E07000039,SOUTH DERBYSHIRE,47802,47721,73.8,17.4,7.2,0.5,1.7,2.7,8.6,0.8,98.4,0,0,43590,8324,3419,228,793,1278,4131,360,47030,0,0,35266,8324,228,565,485,2853,73.8,17.4,0.5,1.2,1,6
E06000025,SOUTH GLOUCESTERSHIRE,124894,124834,25.7,71.6,6.7,0.1,0.3,0.8,2.7,0.2,99.2,0,0,121483,89364,8420,148,387,984,3351,195,123888,0,0,32119,89364,148,239,597,2367,25.7,71.6,0.1,0.2,0.5,1.9
E07000044,SOUTH HAMS,47825,47729,64.5,15.6,11.6,0.8,3.1,7.7,19.7,2.1,93.9,25.8,16.1,38294,7438,5570,391,1473,3665,9435,1006,44914,12362,7715,30856,7438,391,1082,2192,5770,64.5,15.6,0.8,2.3,4.6,12.1
E07000140,SOUTH HOLLAND,43441,43385,80.9,5.9,4.7,0.4,2.4,4.2,13.1,1.2,98.6,0.5,0.5,37690,2543,2032,179,1025,1828,5695,506,42827,231,223,35147,2543,179,846,803,3867,80.9,5.9,0.4,1.9,1.8,8.9
E07000141,SOUTH KESTEVEN,68053,68026,63.6,29,2.3,0.6,1.2,2.1,7.4,0.3,97.8,0,0,62982,19727,1547,424,805,1420,5044,199,66584,27,0,43255,19727,424,381,615,3624,63.6,29,0.6,0.6,0.9,5.3
E07000031,SOUTH LAKELAND,60075,59956,83.7,8.4,8.3,0.5,1.3,2.4,7.7,0.9,98.4,38.8,31.7,55326,5035,4985,324,755,1456,4630,563,59119,23297,19033,50291,5035,324,431,701,3174,83.7,8.4,0.5,0.7,1.2,5.3
S12000029,SOUTH LANARKSHIRE,159139,159025,35.1,59.9,5.4,0.4,1.1,2.3,4.9,0.4,98.3,0,0,151251,95335,8602,693,1724,3661,7774,659,156437,0,0,55916,95335,693,1031,1937,4113,35.1,59.9,0.4,0.6,1.2,2.6
E07000149,SOUTH NORFOLK,64819,64777,80.5,7,2.7,0.4,2.1,4,12.4,1.9,97.2,0,0,56738,4562,1747,282,1386,2597,8039,1200,62979,0,0,52176,4562,282,1104,1211,5442,80.5,7,0.4,1.7,1.9,8.4
E07000155,SOUTH NORTHAMPTONSHIRE,42270,42248,73.8,17.7,13.3,0.2,2.1,3.6,8.4,0.6,95.9,0.7,0.5,38680,7467,5614,74,907,1519,3568,263,40521,282,200,31213,7467,74,833,612,2049,73.8,17.7,0.2,2,1.4,4.8
E07000179,SOUTH OXFORDSHIRE,65780,65746,60,34.9,12.3,0.1,0.5,1,5,0.3,99.5,0,0,62460,22966,8118,93,341,642,3286,179,65450,0,0,39494,22966,93,248,301,2644,60,34.9,0.1,0.4,0.5,4
E07000126,SOUTH RIBBLE,52549,52521,35.4,60.7,1.4,0.1,0.4,0.8,3.8,0.1,99.1,38.3,22.1,50523,31903,743,28,196,442,1998,30,52073,20142,11618,18620,31903,28,168,246,1556,35.4,60.7,0.1,0.3,0.5,3
E07000189,SOUTH SOMERSET,83561,83351,85.9,1.4,1.3,0.6,2.9,5,12.5,1.1,97.1,4.3,4.3,72933,1139,1072,475,2384,4161,10418,915,81104,3568,3568,71794,1139,475,1909,1777,6257,85.9,1.4,0.6,2.3,2.1,7.5
E07000196,SOUTH STAFFORDSHIRE,49593,49558,62.5,29.7,27,0.2,0.8,2.1,7.8,0.1,98.7,1.5,0,45699,14716,13370,86,383,1017,3859,54,48939,726,15,30983,14716,86,297,634,2842,62.5,29.7,0.2,0.6,1.3,5.7
E08000023,SOUTH TYNESIDE,75341,75338,28.1,69.4,0.5,0.1,0.3,0.6,2.5,0,98.7,0,0,73453,52285,381,46,229,432,1885,3,74330,0,0,21168,52285,46,183,203,1453,28.1,69.4,0.1,0.2,0.3,1.9
E06000045,SOUTHAMPTON,116889,116355,10.2,85,8.2,0,0,0.6,4.4,0.5,95.3,0,0,111191,99320,9634,0,32,750,5164,536,111448,0,0,11871,99320,0,32,718,4414,10.2,85,0,0,0.6,3.8
E06000033,SOUTHEND-ON-SEA,86463,86409,36.4,58.8,1.4,0,0,0,4.8,0,96,0,0,82300,50828,1212,0,2,43,4109,42,83042,0,0,31472,50828,0,2,41,4066,36.4,58.8,0,0,0,4.7
E09000028,SOUTHWARK,148753,148457,23.4,68.3,31.7,0,0,0.3,8.1,0.2,91.8,0,0,136399,101610,47097,1,9,408,12058,292,136618,0,0,34789,101610,1,8,399,11650,23.4,68.3,0,0,0.3,7.8
E07000213,SPELTHORNE,44362,44341,15.9,81.9,26.5,0,0,0.4,2.2,0,98.5,0,0,43373,36329,11747,0,4,171,968,18,43700,0,0,7044,36329,0,4,167,797,15.9,81.9,0,0,0.4,1.8
E07000240,ST ALBANS,64097,64080,17.3,79,1.7,0.1,0.2,0.5,3.7,0.1,98.2,0,0,61733,50654,1063,70,147,338,2347,56,62955,0,0,11079,50654,70,77,191,2009,17.3,79,0.1,0.1,0.3,3.1
E08000013,ST. HELENS,87124,87108,17.6,79.9,1.4,0.1,0.4,0.8,2.6,0,98.9,17.3,0.9,84879,69580,1230,103,337,728,2229,16,86155,15046,752,15299,69580,103,234,391,1501,17.6,79.9,0.1,0.3,0.4,1.7
E07000197,STAFFORD,64610,64560,32.3,60.2,3.4,0.3,1,3.1,7.4,0.5,97.4,0.5,0,59798,38900,2177,172,665,2025,4762,299,62919,322,4,20898,38900,172,493,1360,2737,32.3,60.2,0.3,0.8,2.1,4.2
E07000198,STAFFORDSHIRE MOORLANDS,46432,46411,65.7,25.8,1.8,0.7,1.8,3.8,8.4,1.2,98.4,0,0,42491,11962,813,330,844,1743,3920,572,45667,0,0,30529,11962,330,514,899,2177,65.7,25.8,0.7,1.1,1.9,4.7
E07000243,STEVENAGE,39318,39287,13,86.2,0.9,0,0.1,0.2,0.8,0.1,99.3,0,0,38991,33893,347,0,29,60,296,31,39035,0,0,5098,33893,0,29,31,236,13,86.2,0,0.1,0.1,0.6
S12000030,STIRLING,44269,44172,65.7,21.9,17.2,1.6,3.4,5.5,12.2,2.3,96.1,0,0,38753,9677,7632,712,1493,2443,5419,997,42558,0,0,29076,9677,712,781,950,2976,65.7,21.9,1.6,1.8,2.1,6.7
E08000007,STOCKPORT,138760,138687,19.4,79.1,0.7,0,0.1,0.2,1.5,0,99.2,10.9,0,136644,109692,916,23,202,284,2043,65,137661,15096,0,26952,109692,23,179,82,1759,19.4,79.1,0,0.1,0.1,1.3
E06000004,STOCKTON-ON-TEES,90797,90768,23.5,71.6,2.7,0.1,0.7,1.9,4.8,0.1,95.8,12,2.2,86374,65050,2448,82,638,1731,4394,105,87014,10914,2015,21324,65050,82,556,1093,2663,23.5,71.6,0.1,0.6,1.2,2.9
E06000021,STOKE-ON-TRENT,124349,124313,25.4,72.1,0.4,0,0.1,0.3,2.4,0,98.5,0,0,121270,89655,470,2,69,431,3043,37,122467,0,0,31615,89655,2,67,362,2612,25.4,72.1,0,0.1,0.3,2.1
E07000221,STRATFORD-ON-AVON,64125,64010,63.8,28.6,7,0.4,1.4,2.6,7.4,0.5,97.7,4.9,0.9,59253,18336,4477,280,879,1672,4757,345,62674,3119,556,40917,18336,280,599,793,3085,63.8,28.6,0.4,0.9,1.2,4.8
E07000082,STROUD,56312,56289,75.3,12.4,8.7,0.4,1.8,3.3,12.3,0.5,94.3,5.2,0.7,49356,6967,4908,244,1034,1840,6933,254,53079,2951,402,42389,6967,244,790,806,5093,75.3,12.4,0.4,1.4,1.4,9
E08000024,SUNDERLAND,136470,136288,40.5,55.9,4.8,0.1,0.3,1,3.5,0.2,97.8,0,0,131487,76232,6543,115,345,1409,4801,265,133474,0,0,55255,76232,115,230,1064,3392,40.5,55.9,0.1,0.2,0.8,2.5
E07000214,SURREY HEATH,38271,38268,32.3,65,6.5,0,0.1,0.4,2.8,0,99.5,0,0,37212,24869,2491,0,22,162,1056,3,38062,0,0,12343,24869,0,22,140,894,32.3,65,0,0.1,0.4,2.3
E09000029,SUTTON,87015,86976,16.8,81.2,1.9,0,0,0.2,2,0,98.3,0,0,85241,70619,1678,13,26,186,1735,38,85532,0,0,14622,70619,13,13,160,1549,16.8,81.2,0,0,0.2,1.8
E07000113,SWALE,66592,66437,60.3,32.5,1.6,0.2,0.9,2.1,7,0.4,98.6,0,0,61795,21634,1062,148,596,1418,4642,277,65650,0,0,40161,21634,148,448,822,3224,60.3,32.5,0.2,0.7,1.2,4.8
W06000011,SWANSEA,118530,118272,33.6,63.7,13.3,0.1,0.2,0.5,2.5,0.3,98.4,19.1,10.4,115346,75539,15729,111,258,601,2926,370,116648,22669,12338,39807,75539,111,147,343,2325,33.6,63.7,0.1,0.1,0.3,2
E06000030,SWINDON,101018,101004,16,75.8,8.4,0,0.8,2.4,8.2,0.9,92.2,0,0,92703,76525,8486,33,852,2470,8301,913,93132,0,0,16178,76525,33,819,1618,5831,16,75.8,0,0.8,1.6,5.8
E08000008,TAMESIDE,115418,115149,46.4,50.3,11.5,0,0,0.2,3.1,0.2,99.4,0,0,111614,58009,13306,3,21,194,3535,272,114676,0,0,53605,58009,3,18,173,3341,46.4,50.3,0,0,0.1,2.9
E07000199,TAMWORTH,35341,35316,19.1,79.8,1.3,0.1,0.2,0.3,1,0.1,99.6,0,0,34952,28193,476,47,63,98,364,31,35193,0,0,6759,28193,47,16,35,266,19.1,79.8,0.1,0,0.1,0.8
E07000215,TANDRIDGE,38315,38300,47.7,45.6,5.7,0.1,0.5,1.1,6.7,0.2,99.3,0,0,35735,17464,2188,46,202,407,2565,66,38064,0,0,18271,17464,46,156,205,2158,47.7,45.6,0.1,0.4,0.5,5.6
E07000045,TEIGNBRIDGE,65876,65773,60.1,27.1,1.4,0.5,1.8,4.1,12.7,1,95,24.7,8.1,57424,17836,903,355,1182,2706,8349,658,62592,16300,5361,39588,17836,355,827,1524,5643,60.1,27.1,0.5,1.3,2.3,8.6
E06000020,TELFORD AND WREKIN,81024,80964,24.8,72.8,2.6,0.1,0.2,0.4,2.3,0.1,99.1,18.1,2.8,79094,58982,2121,60,139,338,1870,92,80322,14700,2241,20112,58982,60,79,199,1532,24.8,72.8,0.1,0.1,0.2,1.9
E07000076,TENDRING,73359,73335,89.1,3.1,3.1,0.6,1.8,2.8,7.8,0.3,96.9,0,0,67646,2260,2251,440,1306,2083,5689,242,71084,0,0,65386,2260,440,866,777,3606,89.1,3.1,0.6,1.2,1.1,4.9
E07000093,TEST VALLEY,58215,58173,34,58.1,11.6,0.3,1.3,3,7.9,0.9,98.2,0,0,53601,33834,6734,195,754,1724,4572,549,57140,0,0,19767,33834,195,559,970,2848,34,58.1,0.3,1,1.7,4.9
E07000083,TEWKESBURY,46018,45890,38.9,49.1,19.1,0.3,1.9,3.6,11.8,0.9,90,8.5,1.3,40479,22590,8774,123,863,1674,5411,401,41414,3907,593,17889,22590,123,740,811,3737,38.9,49.1,0.3,1.6,1.8,8.1
E07000114,THANET,72174,72040,53.8,43.3,43.2,0,0.2,1,2.7,0.2,99.3,0,0,70096,31233,31198,15,160,722,1944,159,71697,0,0,38863,31233,15,145,562,1222,53.8,43.3,0,0.2,0.8,1.7
E07000102,THREE RIVERS,39333,39329,24.3,71.9,1.4,0.1,0.3,0.6,3.8,0.1,99.5,0,0,37850,28285,537,56,121,230,1479,27,39153,0,0,9565,28285,56,65,109,1249,24.3,71.9,0.1,0.2,0.3,3.2
E06000034,THURROCK,71588,71580,23.8,71.4,6,0,0.5,1.9,4.8,0.1,97,0,0,68161,51116,4284,30,356,1386,3419,98,69453,0,0,17045,51116,30,326,1030,2033,23.8,71.4,0,0.5,1.4,2.8
E07000115,TONBRIDGE AND MALLING,56607,56577,40.5,53.8,6.9,0.2,0.6,1.5,5.7,0.2,98.4,0,0,53362,30464,3927,135,328,849,3215,130,55725,0,0,22898,30464,135,193,521,2366,40.5,53.8,0.2,0.3,0.9,4.2
E06000027,TORBAY,78621,78361,38.4,55,14.8,0,0,0.7,6.3,0.4,95.7,1.6,0,73420,43208,11629,15,28,542,4941,278,75274,1270,0,30212,43208,15,13,514,4399,38.4,55,0,0,0.7,5.6
W06000020,TORFAEN,45613,45583,60.2,35.3,6.2,0.1,0.3,1,4.5,0.1,97.3,57.3,45.9,43542,16089,2807,38,140,440,2041,60,44374,26115,20947,27453,16089,38,102,300,1601,60.2,35.3,0.1,0.2,0.7,3.5
E07000046,TORRIDGE,34132,34056,77.7,3.4,3.4,2.7,7.4,11.6,18.6,2.8,92.8,27.3,14.4,27696,1170,1170,920,2510,3945,6360,971,31673,9321,4920,26526,1170,920,1590,1435,2415,77.7,3.4,2.7,4.7,4.2,7.1
E09000030,TOWER HAMLETS,141361,140781,29.8,60,32.3,0,0,0.6,9.7,0.4,89.9,0,0,127036,84864,45649,0,33,786,13745,553,127073,0,0,42172,84864,0,33,753,12959,29.8,60,0,0,0.5,9.2
E08000009,TRAFFORD,107154,106903,32.4,65.2,2.1,0,0.4,0.5,2.2,0.3,98.8,1.5,0,104593,69831,2236,53,427,534,2310,274,105907,1658,0,34762,69831,53,374,107,1776,32.4,65.2,0,0.3,0.1,1.7
E07000116,TUNBRIDGE WELLS,52025,51999,45.1,45.8,6.8,0.1,1.2,2.9,9.1,1,98.3,0,0,47266,23814,3513,64,629,1530,4733,516,51148,0,0,23452,23814,64,565,901,3203,45.1,45.8,0.1,1.1,1.7,6.2
E07000077,UTTLESFORD,39844,39786,59.8,24.3,7.3,0.5,2.1,5.9,15.8,1.5,91.6,0,0,33496,9688,2904,200,840,2363,6290,609,36509,0,0,23808,9688,200,640,1523,3927,59.8,24.3,0.5,1.6,3.8,9.9
W06000014,VALE OF GLAMORGAN,61713,61663,43.9,51.6,5.3,0.3,1,1.6,4.5,0.6,97.9,11.5,6.2,58916,31823,3272,189,628,987,2747,368,60393,7117,3823,27093,31823,189,439,359,1760,43.9,51.6,0.3,0.7,0.6,2.9
E07000180,VALE OF WHITE HORSE,61272,61238,37,58.5,14.9,0.2,0.4,1.1,4.4,0.2,98.7,0,0,58539,35841,9117,105,258,648,2699,125,60491,0,0,22698,35841,105,153,390,2051,37,58.5,0.2,0.2,0.6,3.3
E08000036,WAKEFIELD,160740,160288,51.5,43.2,12.6,0.1,0.5,0.9,5,0.3,97.6,0.4,0,152195,69389,20271,82,725,1502,8093,513,156807,632,0,82806,69389,82,643,777,6591,51.5,43.2,0.1,0.4,0.5,4.1
E08000030,WALSALL,119420,119389,35.5,63.1,10.5,0,0,0.4,1.4,0,99.3,0,0,117743,75311,12503,4,26,525,1646,28,118555,0,0,42432,75311,4,22,499,1121,35.5,63.1,0,0,0.4,0.9
E09000031,WALTHAM FOREST,109981,109483,10.6,86.1,20,0,0,0.4,2.8,0.5,96.9,0,0,106436,94740,22024,6,27,458,3047,515,106532,0,0,11696,94740,6,21,431,2589,10.6,86.1,0,0,0.4,2.4
E09000032,WANDSWORTH,154914,154654,22.6,74.1,19.9,0,0,0.1,3.1,0.2,96.8,0,0,149866,114855,30905,0,15,189,4788,267,149912,0,0,35011,114855,0,15,174,4599,22.6,74.1,0,0,0.1,3
E06000007,WARRINGTON,98422,98330,39.4,57.6,1.1,0,0.1,0.2,3,0.1,99.3,0.6,0,95415,56661,1041,41,114,220,2915,110,97779,571,34,38754,56661,41,73,106,2695,39.4,57.6,0,0.1,0.1,2.7
E07000222,WARWICK,68313,68266,25.5,71.2,7.4,0.2,0.9,1.3,3.1,0.1,98.8,2,0.6,66121,48668,5053,104,614,903,2145,78,67520,1334,419,17453,48668,104,510,289,1242,25.5,71.2,0.2,0.7,0.4,1.8
E07000103,WATFORD,42002,41977,17.1,82.2,1.5,0,0,0.2,0.7,0.1,99.4,0,0,41695,34529,612,1,13,75,282,24,41732,0,0,7166,34529,1,12,62,207,17.1,82.2,0,0,0.1,0.5
E07000216,WAVERLEY,55890,55861,80.8,12.4,4.3,0.1,0.4,0.8,6.7,0.4,99.6,0,0,52105,6955,2431,67,234,436,3756,219,55685,0,0,45150,6955,67,167,202,3320,80.8,12.4,0.1,0.3,0.4,5.9
E07000065,WEALDEN,73086,73050,87,6,6,0.2,0.8,1.5,7,0.5,99.5,0,0,67968,4383,4382,166,554,1080,5082,393,72747,0,0,63585,4383,166,388,526,4002,87,6,0.2,0.5,0.7,5.5
E07000156,WELLINGBOROUGH,37633,37612,60.8,36.7,3.5,0,0.5,0.9,2.5,0.1,99,14.2,14,36689,13826,1335,17,175,355,923,52,37262,5339,5264,22863,13826,17,158,180,568,60.8,36.7,0,0.4,0.5,1.5
E07000241,WELWYN HATFIELD,49648,49642,26.6,70.1,3.5,0,0.1,0.6,3.3,0,99.2,0,0,48020,34796,1754,8,46,289,1622,24,49254,0,0,13224,34796,8,38,243,1333,26.6,70.1,0,0.1,0.5,2.7
E06000037,WEST BERKSHIRE,72116,71954,35.1,60.4,24.8,0.1,0.4,1,4.3,0.5,97.3,0,0,68886,43583,17914,58,321,732,3068,370,70197,0,0,25303,43583,58,263,411,2336,35.1,60.4,0.1,0.4,0.6,3.2
E07000047,WEST DEVON,26870,26820,75.9,1.2,1.2,1.8,6.1,11.8,22.8,2.9,95.2,41.3,18.9,20700,317,317,490,1648,3176,6120,783,25593,11092,5078,20383,317,490,1158,1528,2944,75.9,1.2,1.8,4.3,5.7,11
S12000039,WEST DUNBARTONSHIRE,46981,46973,10.1,88.2,0.4,0,0.2,0.5,1.6,0,99,0,0,46214,41459,199,19,97,226,759,20,46531,0,0,4755,41459,19,78,129,533,10.1,88.2,0,0.2,0.3,1.1
E07000127,WEST LANCASHIRE,51238,51218,73.6,20,13.8,0.3,0.9,1.8,6.4,0.1,98.5,17.4,5.8,47958,10266,7058,137,447,936,3260,59,50467,8901,2962,37692,10266,137,310,489,2324,73.6,20,0.3,0.6,1,4.5
E07000142,WEST LINDSEY,45569,45442,59.6,25.3,13,1.9,4.5,7.3,14.8,1.3,97,26.5,19.1,38678,11539,5918,868,2070,3305,6764,598,44223,12063,8692,27139,11539,868,1202,1235,3459,59.6,25.3,1.9,2.6,2.7,7.6
S12000040,WEST LOTHIAN,85027,85012,42.7,53.3,9,0.2,0.4,0.8,4,0.2,98.8,0,0,81612,45341,7687,131,353,686,3400,132,84021,0,0,36271,45341,131,222,333,2714,42.7,53.3,0.2,0.3,0.4,3.2
E07000181,WEST OXFORDSHIRE,51010,50989,46.7,48.6,16.7,0.1,0.6,1.8,4.6,0.6,97.9,0,0,48618,24813,8526,67,330,920,2371,297,49940,0,0,23805,24813,67,263,590,1451,46.7,48.6,0.1,0.5,1.2,2.8
E07000245,WEST SUFFOLK,83678,83644,77.6,16.6,2.9,0.2,0.6,1,5.8,0.3,99,0.1,0,78824,13927,2414,165,495,865,4820,281,82839,119,0,64897,13927,165,330,370,3955,77.6,16.6,0.2,0.4,0.4,4.7
E09000033,WESTMINSTER,163436,163221,45.7,38.3,31.8,0,0,0,15.9,0.1,84,0,0,137198,62553,51993,0,0,49,26023,166,137221,0,0,74645,62553,0,0,49,25974,45.7,38.3,0,0,0,15.9
E08000010,WIGAN,152305,152291,28.5,69.9,0.9,0,0.1,0.3,1.6,0,99.6,15.2,0.8,149877,106477,1435,33,191,448,2414,43,151657,23165,1169,43400,106477,33,158,257,1966,28.5,69.9,0,0.1,0.2,1.3
E06000054,WILTSHIRE,230602,230478,57,35.7,7.2,0.3,1,2.1,7.3,0.5,98.4,1,1,213721,82350,16496,757,2215,4763,16757,1138,226808,2325,2325,131371,82350,757,1458,2548,11994,57,35.7,0.3,0.6,1.1,5.2
E07000094,WINCHESTER,56179,56136,49.6,40.6,5.3,0.5,1.5,3,9.7,0.7,97.1,0,0,50684,22810,2994,287,864,1689,5452,387,54553,0,0,27874,22810,287,577,825,3763,49.6,40.6,0.5,1,1.5,6.7
E06000040,WINDSOR AND MAIDENHEAD,66643,66603,37.3,55.6,3.4,0.2,0.4,1.1,7,0.2,97.4,0,0,61925,37086,2264,103,282,735,4678,126,64917,0,0,24839,37086,103,179,453,3943,37.3,55.6,0.2,0.3,0.7,5.9
E08000015,WIRRAL,157653,157606,42.4,54.7,16.4,0,0.1,0.2,2.9,0,99.6,1.4,0,153084,86205,25858,37,124,281,4522,49,157000,2136,0,66879,86205,37,87,157,4241,42.4,54.7,0,0.1,0.1,2.7
E07000217,WOKING,44947,44934,16.6,81.5,3.4,0,0.3,0.4,2,0.1,99.3,0,0,44052,36613,1512,0,144,170,882,24,44615,0,0,7439,36613,0,144,26,712,16.6,81.5,0,0.3,0.1,1.6
E06000041,WOKINGHAM,75522,74652,40.7,50.4,7.2,0,0.3,1.4,7.8,1.2,95.2,0,0,68785,38071,5401,22,230,1060,5867,888,71863,0,0,30714,38071,22,208,830,4807,40.7,50.4,0,0.3,1.1,6.4
E08000031,WOLVERHAMPTON,117996,117880,14.9,83.2,1,0,0,0.3,1.8,0.1,98.4,0,0,115700,98177,1128,0,4,297,2180,116,116093,0,0,17523,98177,0,4,293,1883,14.9,83.2,0,0,0.2,1.6
E07000237,WORCESTER,48646,48607,91.6,6.6,1.2,0,0,0,1.8,0.1,99.6,43,4.6,47737,3191,599,0,1,11,870,38,48436,20925,2229,44546,3191,0,1,10,859,91.6,6.6,0,0,0,1.8
E07000229,WORTHING,51419,51413,22.2,77.1,1.7,0,0,0,0.6,0,99.7,0,0,51090,39664,886,0,1,7,323,5,51289,0,0,11426,39664,0,1,6,316,22.2,77.1,0,0,0,0.6
W06000006,WREXHAM,65697,65105,66.4,27.1,26.6,0.4,0.9,1.8,5.6,0.6,97.3,38.9,8.4,61407,17808,17476,233,618,1151,3698,427,63921,25576,5532,43599,17808,233,385,533,2547,66.4,27.1,0.4,0.6,0.8,3.9
E07000238,WYCHAVON,62475,62114,82.9,8.6,5.1,0.2,0.9,2,8,0.9,97.8,9.3,1.4,57130,5352,3162,129,553,1223,4984,555,61070,5827,848,51778,5352,129,424,670,3761,82.9,8.6,0.2,0.7,1.1,6
E07000007,WYCOMBE,76433,76345,68.5,26.5,2.2,0.1,0.6,1,4.9,0.3,99.2,0,0,72564,20219,1664,90,489,731,3781,219,75802,0,0,52345,20219,90,399,242,3050,68.5,26.5,0.1,0.5,0.3,4
E07000128,WYRE,56343,56280,88.4,5.9,5.5,0.1,0.3,0.7,5.5,0.1,98.8,7.3,1.4,53173,3340,3108,69,183,382,3107,71,55673,4110,775,49833,3340,69,114,199,2725,88.4,5.9,0.1,0.2,0.4,4.8
E07000239,WYRE FOREST,48100,48061,49.3,46.7,0.9,0.3,0.6,1.4,3.9,0.5,99.4,2.9,0.4,46203,22479,420,140,291,662,1858,264,47829,1412,172,23724,22479,140,151,371,1196,49.3,46.7,0.3,0.3,0.8,2.5
E06000014,YORK,98735,98548,23,70.8,43.6,0,0.3,0.6,6,0.2,95.6,7,3.9,92626,69871,43077,36,261,629,5922,191,94419,6956,3811,22755,69871,36,225,368,5293,23,70.8,0,0.2,0.4,5.4
