laua,laua_name,All Premises,All Matched Premises,SFBB availability (% premises),UFBB availability (% premises),Full Fibre availability (% premises),% of premises unable to receive 2Mbit/s,% of premises unable to receive 5Mbit/s,% of premises unable to receive 10Mbit/s,% of premises unable to receive 30Mbit/s,% of premises below the USO,% of premises with NGA,% of premises able to receive decent broadband from FWA,% of premises able to receive SFBB from FWA,Number of premises with SFBB availability,Number of premises with UFBB availability,Number of premises with Full Fibre availability,Number of premises unable to receive 2Mbit/s,Number of premises unable to receive 5Mbit/s,Number of premises unable to receive 10Mbit/s,Number of premises unable to receive 30Mbit/s,Number of premises below the USO,Number of premises with NGA,Number of premises able to receive decent broadband from FWA,Number of premises able to receive SFBB from FWA,Number of premises with 30<300Mbit/s download speed,Number of premises with >=300Mbit/s download speed,Number of premises with 0<2Mbit/s download speed,Number of premises with 2<5Mbit/s download speed,Number of premises with 5<10Mbit/s download speed,Number of premises with 10<30Mbit/s download speed,% of premises with 30<300Mbit/s download speed,% of premises with >=300Mbit/s download speed,% of premises with 0<2Mbit/s download speed,% of premises with 2<5Mbit/s download speed,% of premises with 5<10Mbit/s download speed,% of premises with 10<30Mbit/s download speed
S12000033,ABERDEEN CITY,125621,125416,93.9,30.0,22.1,0.0,0.2,0.7,5.9,1.0,96.8,0.0,0.0,117966,37638,27823,53,223,896,7450,1197,121662,0,0,80328,37638,53,170,673,6554,63.9,30.0,0.0,0.1,0.5,5.2
S12000034,ABERDEENSHIRE,125388,124596,82.0,3.2,3.1,2.5,5.7,9.6,17.4,10.7,93.9,0.0,0.0,102794,4022,3889,3098,7120,12067,21802,13392,117748,0,0,98772,4022,3098,4022,4947,9735,78.8,3.2,2.5,3.2,3.9,7.8
E07000223,ADUR,29784,29771,99.1,81.7,0.6,0.0,0.0,0.1,0.9,0.1,99.5,0.0,0.0,29507,24319,186,0,11,28,264,43,29630,0,0,5188,24319,0,11,17,236,17.4,81.7,0.0,0.0,0.1,0.8
E07000026,ALLERDALE,51493,51378,92.1,2.3,2.3,1.2,2.4,3.4,7.7,3.7,98.7,2.3,2.2,47422,1174,1174,597,1231,1749,3956,1920,50822,1162,1112,46248,1174,597,634,518,2207,89.8,2.3,1.2,1.2,1.0,4.3
E07000032,AMBER VALLEY,60882,60755,93.3,25.5,22.3,0.1,0.9,2.0,6.5,2.3,98.1,0.0,0.0,56818,15536,13557,91,577,1231,3937,1406,59716,0,0,41282,15536,91,486,654,2706,67.8,25.5,0.1,0.8,1.1,4.4
S12000041,ANGUS,60681,60276,86.9,13.7,1.5,1.4,3.7,6.9,12.4,7.8,95.2,0.0,0.0,52749,8304,896,853,2257,4202,7527,4758,57789,0,0,44445,8304,853,1404,1945,3325,73.2,13.7,1.4,2.3,3.2,5.5
N09000001,ANTRIM AND NEWTOWNABBEY,61036,60499,91.2,55.9,31.3,1.7,3.0,3.8,8.0,4.7,98.3,0.0,0.0,55643,34113,19128,1041,1818,2331,4856,2871,60026,0,0,21530,34113,1041,777,513,2525,35.3,55.9,1.7,1.3,0.8,4.1
N09000011,ARDS AND NORTH DOWN,72718,72510,94.6,61.5,57.1,0.5,1.1,2.2,5.1,2.5,99.5,0.0,0.0,68773,44736,41498,393,823,1579,3737,1798,72371,0,0,24037,44736,393,430,756,2158,33.1,61.5,0.5,0.6,1.0,3.0
S12000035,ARGYLL AND BUTE,56278,54856,77.3,1.1,1.1,3.2,6.1,10.9,20.2,13.9,87.9,0.0,0.0,43498,603,602,1827,3448,6123,11358,7840,49495,0,0,42895,603,1827,1621,2675,5235,76.2,1.1,3.2,2.9,4.8,9.3
N09000002,"ARMAGH CITY, BANBRIDGE AND CRAIGAVON",86219,85759,88.0,42.2,42.2,1.5,3.2,4.9,11.4,5.5,98.3,0.0,0.0,75893,36376,36377,1314,2717,4247,9866,4774,84746,1,0,39517,36376,1314,1403,1530,5619,45.8,42.2,1.5,1.6,1.8,6.5
E07000224,ARUN,78566,78539,96.8,6.0,3.3,0.1,0.2,0.3,3.1,0.4,99.7,0.0,0.0,76083,4741,2608,77,127,269,2456,344,78329,0,0,71342,4741,77,50,142,2187,90.8,6.0,0.1,0.1,0.2,2.8
E07000170,ASHFIELD,59072,59033,98.5,85.3,1.5,0.0,0.4,0.4,1.4,0.5,99.2,0.0,0.0,58186,50396,863,9,208,250,847,291,58578,0,0,7790,50396,9,199,42,597,13.2,85.3,0.0,0.3,0.1,1.0
E07000105,ASHFORD,58131,58054,90.1,44.0,6.0,0.4,1.8,3.8,9.8,4.0,98.4,0.0,0.0,52354,25598,3477,214,1029,2185,5700,2333,57204,0,0,26756,25598,214,815,1156,3515,46.0,44.0,0.4,1.4,2.0,6.0
E07000004,AYLESBURY VALE,88030,87888,92.3,45.6,12.2,0.5,1.7,3.0,7.5,3.3,96.4,0.0,0.0,81246,40128,10728,411,1453,2605,6642,2865,84857,0,0,41118,40128,411,1042,1152,4037,46.7,45.6,0.5,1.2,1.3,4.6
E07000200,BABERGH,43082,42997,93.0,10.8,6.7,0.5,1.1,1.8,6.8,2.0,98.8,0.0,0.0,40083,4659,2896,224,482,769,2914,873,42564,0,0,35424,4659,224,258,287,2145,82.2,10.8,0.5,0.6,0.7,5.0
E09000002,BARKING AND DAGENHAM,80447,80428,98.9,90.5,50.9,0.0,0.3,0.4,1.0,0.5,99.0,0.0,0.0,79600,72802,40937,18,231,360,828,412,79605,0,0,6798,72802,18,213,129,468,8.5,90.5,0.0,0.3,0.2,0.6
E09000003,BARNET,158504,158437,97.3,53.3,20.4,0.0,0.0,0.1,2.6,0.3,98.3,0.0,0.0,154266,84557,32356,0,15,115,4171,478,155764,0,0,69709,84557,0,15,100,4056,44.0,53.3,0.0,0.0,0.1,2.6
E08000016,BARNSLEY,117029,116965,98.0,61.6,19.9,0.1,0.3,0.4,2.0,0.5,99.3,0.0,0.0,114676,72122,23266,118,300,473,2289,600,116171,0,0,42554,72122,118,182,173,1816,36.4,61.6,0.1,0.2,0.1,1.6
E07000027,BARROW-IN-FURNESS,35464,35437,98.6,0.7,0.7,0.2,0.2,0.4,1.3,0.5,99.9,0.1,0.1,34962,259,259,54,82,148,475,177,35427,35,35,34703,259,54,28,66,327,97.9,0.7,0.2,0.1,0.2,0.9
E07000066,BASILDON,83565,83445,96.7,69.5,13.3,0.0,0.2,0.5,3.1,0.8,99.1,0.0,0.0,80833,58041,11098,10,196,421,2612,631,82853,0,0,22792,58041,10,186,225,2191,27.3,69.5,0.0,0.2,0.3,2.6
E07000084,BASINGSTOKE AND DEANE,80648,80607,95.4,50.8,17.7,0.3,0.9,1.6,4.6,1.8,98.7,0.0,0.0,76898,40954,14294,267,704,1276,3709,1413,79563,0,0,35944,40954,267,437,572,2433,44.6,50.8,0.3,0.5,0.7,3.0
E07000171,BASSETLAW,56221,56094,95.9,28.0,5.0,0.4,0.8,1.2,3.9,1.5,99.2,6.8,5.0,53889,15740,2804,238,453,685,2205,838,55778,3829,2809,38149,15740,238,215,232,1520,67.9,28.0,0.4,0.4,0.4,2.7
E06000022,BATH AND NORTH EAST SOMERSET,88542,88424,89.9,50.9,19.7,0.2,0.6,1.9,10.0,2.4,94.2,0.0,0.0,79579,45025,17401,219,544,1642,8845,2137,83413,0,0,34554,45025,219,325,1098,7203,39.0,50.9,0.2,0.4,1.2,8.1
E06000055,BEDFORD,80774,80734,96.5,70.2,8.9,0.1,0.5,0.9,3.5,1.2,98.9,0.0,0.0,77907,56668,7169,113,380,706,2827,929,79849,0,0,21239,56668,113,267,326,2121,26.3,70.2,0.1,0.3,0.4,2.6
N09000003,BELFAST,167050,166354,97.4,89.7,62.6,0.0,0.0,0.4,2.2,1.0,97.7,0.0,0.0,162752,149924,104551,20,83,670,3602,1728,163169,0,0,12828,149924,20,63,587,2932,7.7,89.7,0.0,0.0,0.4,1.8
E09000004,BEXLEY,103275,103209,96.6,75.4,14.4,0.0,0.1,1.1,3.4,1.7,97.2,0.0,0.0,99719,77900,14843,27,143,1139,3490,1806,100350,0,0,21819,77900,27,116,996,2351,21.1,75.4,0.0,0.1,1.0,2.3
E08000025,BIRMINGHAM,471246,470622,95.2,83.4,24.5,0.0,0.1,0.9,4.7,1.3,95.2,0.0,0.0,448471,393237,115611,53,515,4081,22151,6059,448603,0,0,55234,393237,53,462,3566,18070,11.7,83.4,0.0,0.1,0.8,3.8
E07000129,BLABY,45248,45222,97.8,67.8,33.6,0.1,0.3,0.4,2.1,0.6,98.9,0.0,0.0,44253,30693,15199,38,123,178,969,266,44734,0,0,13560,30693,38,85,55,791,30.0,67.8,0.1,0.2,0.1,1.7
E06000008,BLACKBURN WITH DARWEN,67086,67028,97.6,63.1,6.3,0.0,0.2,0.5,2.3,0.6,99.1,46.6,22.7,65476,42319,4254,24,165,345,1552,415,66502,31281,15230,23157,42319,24,141,180,1207,34.5,63.1,0.0,0.2,0.3,1.8
E06000009,BLACKPOOL,76501,76439,99.0,66.7,0.3,0.0,0.0,0.0,0.9,0.1,99.1,0.0,0.0,75714,51018,249,0,10,29,725,92,75783,0,0,24696,51018,0,10,19,696,32.3,66.7,0.0,0.0,0.0,0.9
W06000019,BLAENAU GWENT,35198,35143,97.2,1.7,1.6,0.0,0.2,0.7,2.7,0.8,99.4,0.0,0.0,34196,590,547,15,67,235,947,290,34981,14,0,33606,590,15,52,168,712,95.5,1.7,0.0,0.1,0.5,2.0
E07000033,BOLSOVER,38426,38402,94.2,28.8,4.2,0.1,0.3,0.7,5.7,1.0,98.6,0.0,0.0,36194,11085,1618,27,106,250,2208,378,37886,0,0,25109,11085,27,79,144,1958,65.3,28.8,0.1,0.2,0.4,5.1
E08000001,BOLTON,133512,133358,98.4,80.8,0.8,0.0,0.1,0.3,1.5,0.5,99.2,4.4,2.5,131354,107853,1041,35,146,411,2004,670,132400,5898,3393,23501,107853,35,111,265,1593,17.6,80.8,0.0,0.1,0.2,1.2
E07000136,BOSTON,33111,32858,90.9,3.6,3.6,0.9,1.9,2.8,8.3,3.6,97.3,2.9,2.9,30110,1192,1192,312,644,929,2748,1189,32227,966,963,28918,1192,312,332,285,1819,87.3,3.6,0.9,1.0,0.9,5.5
E06000058,"BOURNEMOUTH, CHRISTCHURCH AND POOLE",196375,196070,98.6,75.6,10.0,0.2,0.2,0.3,1.2,0.5,99.3,0.0,0.0,193628,148554,19653,353,404,627,2442,969,194922,0,0,45074,148554,353,51,223,1815,23.0,75.6,0.2,0.0,0.1,0.9
E06000036,BRACKNELL FOREST,53339,53319,95.5,57.3,6.1,0.2,0.3,1.5,4.4,1.6,98.0,0.0,0.0,50953,30582,3246,89,180,776,2366,828,52257,0,0,20371,30582,89,91,596,1590,38.2,57.3,0.2,0.2,1.1,3.0
E08000032,BRADFORD,211546,211085,96.4,75.8,2.1,0.1,0.3,0.6,3.4,0.8,97.8,44.2,16.1,203974,160381,4387,183,629,1219,7111,1796,206925,93601,34078,43593,160381,183,446,590,5892,20.6,75.8,0.1,0.2,0.3,2.8
E07000067,BRAINTREE,70449,70348,89.2,4.9,4.9,0.9,2.2,3.6,10.6,4.0,94.7,0.0,0.0,62851,3457,3420,605,1568,2565,7497,2815,66694,0,0,59394,3457,605,963,997,4932,84.3,4.9,0.9,1.4,1.4,7.0
E07000143,BRECKLAND,65789,65696,88.7,4.5,2.9,0.8,2.3,3.9,11.2,4.2,97.1,0.0,0.0,58360,2959,1908,549,1525,2580,7336,2761,63880,0,0,55401,2959,549,976,1055,4756,84.2,4.5,0.8,1.5,1.6,7.2
E09000005,BRENT,133198,132693,96.7,59.6,15.9,0.0,0.0,0.4,3.0,1.0,96.8,0.0,0.0,128742,79373,21184,5,63,589,3951,1291,128985,0,0,49369,79373,5,58,526,3362,37.1,59.6,0.0,0.0,0.4,2.5
E07000068,BRENTWOOD,35461,35435,94.6,2.6,2.6,0.1,0.2,0.5,5.3,0.6,99.3,0.0,0.0,33548,931,930,37,88,171,1887,211,35197,0,0,32617,931,37,51,83,1716,92.0,2.6,0.1,0.1,0.2,4.8
W06000013,BRIDGEND,66951,66910,96.1,19.9,14.7,0.1,0.2,1.0,3.8,1.1,98.6,29.0,18.2,64343,13354,9840,63,115,644,2567,758,66002,19443,12184,50989,13354,63,52,529,1923,76.2,19.9,0.1,0.1,0.8,2.9
E06000043,BRIGHTON AND HOVE,144959,144747,97.6,78.5,1.6,0.0,0.1,0.5,2.3,0.9,97.8,0.0,0.0,141448,113734,2336,4,73,702,3299,1243,141797,0,0,27714,113734,4,69,629,2597,19.1,78.5,0.0,0.0,0.4,1.8
E06000023,"BRISTOL, CITY OF",214239,213924,95.4,85.9,35.9,0.0,0.1,0.5,4.5,0.8,95.5,0.0,0.0,204367,183965,76810,6,114,1018,9557,1776,204551,0,0,20402,183965,6,108,904,8539,9.5,85.9,0.0,0.1,0.4,4.0
E07000144,BROADLAND,61546,61335,93.0,37.4,6.1,0.3,1.1,2.6,6.6,3.0,97.8,0.0,0.0,57253,23002,3726,206,693,1601,4082,1864,60181,0,0,34251,23002,206,487,908,2481,55.7,37.4,0.3,0.8,1.5,4.0
E09000006,BROMLEY,145930,145898,97.5,85.1,1.1,0.0,0.2,0.5,2.5,0.6,98.4,0.0,0.0,142298,124257,1618,57,347,712,3600,823,143593,0,0,18041,124257,57,290,365,2888,12.4,85.1,0.0,0.2,0.3,2.0
E07000234,BROMSGROVE,44793,44733,94.7,28.4,7.9,0.1,0.8,1.3,5.2,1.5,99.2,1.6,0.0,42423,12700,3523,56,341,600,2310,662,44427,719,13,29723,12700,56,285,259,1710,66.4,28.4,0.1,0.6,0.6,3.8
E07000095,BROXBOURNE,42979,42965,98.7,84.1,0.9,0.1,0.1,0.3,1.3,0.3,99.3,0.0,0.0,42418,36147,391,28,47,108,547,122,42694,0,0,6271,36147,28,19,61,439,14.6,84.1,0.1,0.0,0.1,1.0
E07000172,BROXTOWE,52324,52287,99.1,89.5,0.8,0.0,0.1,0.2,0.9,0.3,99.6,0.0,0.0,51839,46827,432,16,74,106,448,146,52117,0,0,5012,46827,16,58,32,342,9.6,89.5,0.0,0.1,0.1,0.7
E07000117,BURNLEY,45285,45204,98.0,78.4,0.7,0.1,0.1,0.3,1.8,0.5,99.4,45.3,11.2,44367,35521,335,36,47,132,837,213,45011,20523,5083,8846,35521,36,11,85,705,19.5,78.4,0.1,0.0,0.2,1.6
E08000002,BURY,88431,88005,97.1,49.1,14.1,0.0,0.1,0.2,2.4,0.7,99.4,0.1,0.0,85904,43402,12489,12,94,175,2101,601,87881,98,0,42502,43402,12,82,81,1926,48.1,49.1,0.0,0.1,0.1,2.2
W06000018,CAERPHILLY,82826,82798,97.2,11.9,7.3,0.0,0.1,0.3,2.7,0.3,99.8,32.1,23.7,80536,9855,6057,41,110,238,2262,279,82641,26622,19625,70681,9855,41,69,128,2024,85.3,11.9,0.0,0.1,0.2,2.4
E08000033,CALDERDALE,103667,103599,94.9,43.1,5.9,0.1,0.4,0.8,5.1,0.9,98.8,0.0,0.0,98359,44660,6131,94,374,815,5240,927,102471,26,25,53699,44660,94,280,441,4425,51.8,43.1,0.1,0.3,0.4,4.3
E07000008,CAMBRIDGE,60620,60527,98.2,85.3,10.7,0.0,0.0,0.3,1.6,0.6,98.3,0.4,0.0,59531,51691,6475,0,19,199,996,375,59613,269,0,7840,51691,0,19,180,797,12.9,85.3,0.0,0.0,0.3,1.3
E09000007,CAMDEN,121019,120326,95.4,85.8,13.6,0.0,0.0,0.0,4.1,0.6,95.4,0.0,0.0,115422,103871,16508,0,0,43,4904,765,115423,0,0,11551,103871,0,0,43,4861,9.5,85.8,0.0,0.0,0.0,4.0
E07000192,CANNOCK CHASE,47126,47104,97.2,22.4,0.8,0.0,0.1,0.1,2.7,0.6,99.2,0.0,0.0,45827,10536,389,9,31,39,1277,278,46747,0,0,35291,10536,9,22,8,1238,74.9,22.4,0.0,0.0,0.0,2.6
E07000106,CANTERBURY,74670,74474,93.4,2.9,2.9,0.2,0.6,1.2,6.3,1.5,99.2,0.0,0.0,69776,2131,2131,177,465,920,4698,1120,74103,0,0,67645,2131,177,288,455,3778,90.6,2.9,0.2,0.4,0.6,5.1
W06000015,CARDIFF,167446,166840,97.0,79.8,35.5,0.0,0.1,0.5,2.6,1.1,97.6,54.0,25.9,162486,133560,59526,27,233,835,4354,1767,163461,90361,43391,28926,133560,27,206,602,3519,17.3,79.8,0.0,0.1,0.4,2.1
E07000028,CARLISLE,56744,56648,93.4,46.1,3.4,0.8,1.7,3.2,6.4,3.8,97.2,0.1,0.1,53009,26148,1936,456,983,1835,3639,2171,55128,36,36,26861,26148,456,527,852,1804,47.3,46.1,0.8,0.9,1.5,3.2
W06000010,CARMARTHENSHIRE,92682,92201,86.1,15.6,16.1,2.0,4.4,7.0,13.4,8.0,93.2,12.3,8.1,79764,14492,14937,1818,4112,6530,12437,7393,86414,11359,7484,65272,14492,1818,2294,2418,5907,70.4,15.6,2.0,2.5,2.6,6.4
E07000069,CASTLE POINT,40947,40812,98.8,43.5,2.1,0.0,0.1,0.2,0.9,0.6,99.4,0.0,0.0,40441,17829,858,4,56,97,371,232,40692,0,0,22612,17829,4,52,41,274,55.2,43.5,0.0,0.1,0.1,0.7
N09000004,CAUSEWAY COAST AND GLENS,66130,64742,85.0,21.3,21.3,2.3,4.4,6.2,12.9,8.3,97.2,0.0,0.0,56235,14087,14083,1529,2915,4095,8507,5509,64301,0,0,42148,14087,1529,1386,1180,4412,63.7,21.3,2.3,2.1,1.8,6.7
E06000056,CENTRAL BEDFORDSHIRE,125642,125587,96.3,62.3,8.0,0.1,0.7,1.2,3.7,1.4,98.7,0.0,0.0,120938,78257,10024,121,886,1567,4649,1743,124029,0,0,42681,78257,121,765,681,3082,34.0,62.3,0.1,0.6,0.5,2.5
W06000008,CEREDIGION,37507,37283,79.0,17.8,17.8,3.2,7.4,12.3,20.4,13.7,88.5,3.3,2.6,29637,6684,6685,1187,2785,4621,7646,5132,33190,1232,987,22953,6684,1187,1598,1836,3025,61.2,17.8,3.2,4.3,4.9,8.1
E07000130,CHARNWOOD,78208,77959,97.9,70.9,9.3,0.1,0.2,0.5,1.8,0.9,99.1,0.0,0.0,76585,55462,7258,75,179,382,1374,688,77469,0,0,21123,55462,75,104,203,992,27.0,70.9,0.1,0.1,0.3,1.3
E07000070,CHELMSFORD,81759,81727,94.0,46.4,6.1,0.1,0.5,1.1,6.0,1.2,98.2,0.0,0.0,76843,37938,5023,111,416,890,4884,963,80297,0,0,38905,37938,111,305,474,3994,47.6,46.4,0.1,0.4,0.6,4.9
E07000078,CHELTENHAM,60022,59979,98.3,69.4,5.3,0.0,0.1,0.2,1.6,0.3,99.2,0.0,0.0,59014,41684,3190,9,47,122,965,170,59552,0,0,17330,41684,9,38,75,843,28.9,69.4,0.0,0.1,0.1,1.4
E07000177,CHERWELL,70338,70243,95.3,37.4,9.4,0.2,0.4,1.1,4.5,1.3,97.8,0.0,0.0,67061,26316,6594,156,296,746,3182,890,68825,0,0,40745,26316,156,140,450,2436,57.9,37.4,0.2,0.2,0.6,3.5
E06000049,CHESHIRE EAST,188897,188709,92.8,33.4,4.2,0.3,0.9,1.9,7.1,2.1,98.1,5.2,0.6,175278,63087,7944,653,1730,3596,13431,3933,185266,9912,1192,112191,63087,653,1077,1866,9835,59.4,33.4,0.3,0.6,1.0,5.2
E06000050,CHESHIRE WEST AND CHESTER,169587,169441,94.6,26.8,8.4,0.2,0.7,1.3,5.3,1.4,98.7,5.9,0.0,160504,45414,14242,270,1114,2158,8937,2375,167406,9985,0,115090,45414,270,844,1044,6779,67.9,26.8,0.2,0.5,0.6,4.0
E07000034,CHESTERFIELD,53130,53092,96.7,36.7,8.1,0.0,0.1,0.5,3.2,0.6,99.1,0.0,0.0,51391,19508,4318,14,31,256,1701,298,52677,0,0,31883,19508,14,17,225,1445,60.0,36.7,0.0,0.0,0.4,2.7
E07000225,CHICHESTER,61797,61558,91.1,19.8,18.2,0.5,1.2,2.4,8.5,2.8,98.6,0.0,0.0,56302,12211,11250,331,726,1480,5256,1745,60908,0,0,44091,12211,331,395,754,3776,71.3,19.8,0.5,0.6,1.2,6.1
E07000005,CHILTERN,42631,42624,93.1,43.7,1.1,0.0,0.2,2.2,6.9,2.3,99.6,0.0,0.0,39687,18648,472,21,89,944,2937,970,42472,0,0,21039,18648,21,68,855,1993,49.4,43.7,0.0,0.2,2.0,4.7
E07000118,CHORLEY,54280,54225,94.8,51.1,7.1,0.1,1.0,1.6,5.1,1.7,98.4,43.1,22.3,51471,27725,3830,32,565,858,2754,917,53388,23384,12127,23746,27725,32,533,293,1896,43.7,51.1,0.1,1.0,0.5,3.5
S12000036,CITY OF EDINBURGH,264352,264326,97.3,82.8,26.9,0.0,0.2,0.4,2.6,0.7,97.8,0.0,0.0,257341,218944,71110,111,443,936,6985,1857,258443,0,0,38397,218944,111,332,493,6049,14.5,82.8,0.0,0.1,0.2,2.3
E09000001,CITY OF LONDON,11051,11032,53.4,23.6,23.1,0.0,0.0,0.0,46.4,0.2,53.4,0.0,0.0,5902,2605,2548,0,0,1,5130,20,5902,0,0,3297,2605,0,0,1,5129,29.8,23.6,0.0,0.0,0.0,46.4
S12000005,CLACKMANNANSHIRE,25640,25544,94.4,6.2,0.8,0.1,0.2,0.4,5.3,0.7,99.4,0.0,0.0,24192,1579,213,27,44,95,1352,192,25491,0,0,22613,1579,27,17,51,1257,88.2,6.2,0.1,0.1,0.2,4.9
E07000071,COLCHESTER,87600,87092,92.4,50.8,5.8,0.7,1.8,3.1,7.0,4.0,95.5,0.0,0.0,80986,44500,5105,573,1537,2702,6106,3540,83652,0,0,36486,44500,573,964,1165,3404,41.7,50.8,0.7,1.1,1.3,3.9
W06000003,CONWY,59236,59187,93.1,4.5,4.5,0.7,2.1,3.3,6.8,3.7,97.2,50.5,35.9,55137,2671,2671,423,1220,1979,4050,2180,57581,29915,21254,52466,2671,423,797,759,2071,88.6,4.5,0.7,1.3,1.3,3.5
E07000029,COPELAND,35518,35461,94.9,1.4,1.4,0.3,0.7,1.6,4.9,1.7,99.1,0.0,0.0,33714,511,511,98,264,553,1747,611,35202,0,0,33203,511,98,166,289,1194,93.5,1.4,0.3,0.5,0.8,3.4
E07000150,CORBY,32384,32301,98.2,57.8,14.6,0.1,0.4,0.5,1.6,0.7,98.8,0.0,0.0,31785,18727,4734,30,120,146,516,230,31981,0,0,13058,18727,30,90,26,370,40.3,57.8,0.1,0.3,0.1,1.1
E06000052,CORNWALL,297959,296872,89.2,34.9,31.9,0.3,1.2,2.5,10.5,3.2,94.5,3.4,1.3,265645,103872,95007,1028,3477,7378,31227,9672,281549,10244,3981,161773,103872,1028,2449,3901,23849,54.3,34.9,0.3,0.8,1.3,8.0
E07000079,COTSWOLD,46835,46789,90.7,31.6,31.5,0.2,0.9,2.4,9.2,2.9,93.3,0.1,0.1,42489,14820,14771,108,426,1130,4300,1381,43710,50,50,27669,14820,108,318,704,3170,59.1,31.6,0.2,0.7,1.5,6.8
E06000047,COUNTY DURHAM,258634,258408,93.5,11.6,7.8,0.3,0.8,1.5,6.4,1.8,98.7,0.2,0.0,241901,29995,20102,850,2045,3886,16507,4703,255263,636,78,211906,29995,850,1195,1841,12621,81.9,11.6,0.3,0.5,0.7,4.9
E08000026,COVENTRY,149589,149145,95.9,80.4,45.3,0.0,0.4,0.9,3.8,1.6,96.3,0.0,0.0,143449,120283,67802,11,631,1372,5696,2322,144126,0,0,23166,120283,11,620,741,4324,15.5,80.4,0.0,0.4,0.5,2.9
E07000163,CRAVEN,29891,29808,91.5,14.4,9.4,1.2,2.4,3.8,8.2,4.1,97.2,37.1,24.1,27344,4315,2810,369,706,1134,2464,1234,29041,11096,7197,23029,4315,369,337,428,1330,77.0,14.4,1.2,1.1,1.4,4.4
E07000226,CRAWLEY,48650,48635,99.0,84.2,2.4,0.0,0.1,0.3,0.9,0.3,99.8,0.0,0.0,48177,40943,1156,4,26,126,458,142,48529,0,0,7234,40943,4,22,100,332,14.9,84.2,0.0,0.0,0.2,0.7
E09000008,CROYDON,166786,166664,96.0,75.7,14.9,0.0,0.0,0.3,4.0,0.5,96.5,0.0,0.0,160073,126232,24845,1,55,442,6591,909,161015,0,0,33841,126232,1,54,387,6149,20.3,75.7,0.0,0.0,0.2,3.7
E07000096,DACORUM,68410,68361,95.9,72.2,3.8,0.1,0.5,1.1,4.0,1.2,98.8,0.0,0.0,65636,49366,2583,70,343,726,2725,832,67606,0,0,16270,49366,70,273,383,1999,23.8,72.2,0.1,0.4,0.6,2.9
E06000005,DARLINGTON,54165,54116,93.3,82.2,1.6,0.6,2.2,3.5,6.7,3.6,94.8,18.3,3.9,50509,44510,856,335,1192,1874,3607,1977,51349,9934,2091,5999,44510,335,857,682,1733,11.1,82.2,0.6,1.6,1.3,3.2
E07000107,DARTFORD,48938,48918,95.6,49.0,12.0,0.2,0.6,1.5,4.4,1.9,97.7,0.0,0.0,46784,23982,5897,106,299,731,2134,928,47819,0,0,22802,23982,106,193,432,1403,46.6,49.0,0.2,0.4,0.9,2.9
E07000151,DAVENTRY,37950,37924,93.7,26.3,21.3,0.5,1.4,2.4,6.2,2.7,97.5,0.0,0.0,35555,9980,8071,188,523,919,2369,1019,37019,0,0,25575,9980,188,335,396,1450,67.4,26.3,0.5,0.9,1.0,3.8
W06000004,DENBIGHSHIRE,49317,49143,90.0,5.4,5.4,0.8,1.9,4.2,9.6,4.9,94.7,47.7,2.7,44395,2667,2667,387,930,2086,4748,2441,46709,23510,1310,41728,2667,387,543,1156,2662,84.6,5.4,0.8,1.1,2.3,5.4
E06000015,DERBY,118258,118141,99.2,87.8,4.7,0.0,0.0,0.1,0.7,0.2,99.4,0.0,0.0,117255,103782,5524,1,17,144,886,286,117558,0,0,13473,103782,1,16,127,742,11.4,87.8,0.0,0.0,0.1,0.6
E07000035,DERBYSHIRE DALES,37123,37044,87.4,6.4,6.4,0.6,2.4,5.1,12.4,5.7,95.7,0.0,0.0,32446,2394,2394,220,876,1876,4598,2104,35539,0,0,30052,2394,220,656,1000,2722,81.0,6.4,0.6,1.8,2.7,7.3
N09000005,DERRY CITY AND STRABANE,62612,62399,90.7,70.6,49.0,2.1,3.6,4.8,8.9,5.2,98.7,0.0,0.0,56816,44216,30706,1333,2262,3032,5583,3271,61807,0,0,12600,44216,1333,929,770,2551,20.1,70.6,2.1,1.5,1.2,4.1
E08000017,DONCASTER,145903,145805,96.8,45.5,9.2,0.1,0.4,0.7,3.1,0.9,98.7,14.7,13.9,141237,66316,13447,117,577,1086,4568,1334,143998,21406,20330,74921,66316,117,460,509,3482,51.3,45.5,0.1,0.3,0.3,2.4
E06000059,DORSET,189013,188341,91.9,6.5,3.9,0.3,1.0,1.9,7.7,2.3,98.1,7.6,7.6,173765,12322,7459,532,1916,3621,14576,4409,185509,14323,14323,161443,12322,532,1384,1705,10955,85.4,6.5,0.3,0.7,0.9,5.8
E07000108,DOVER,55311,55261,92.7,28.6,1.9,0.5,1.0,2.1,7.2,2.4,98.1,0.0,0.0,51252,15813,1051,296,552,1159,4009,1310,54287,0,0,35439,15813,296,256,607,2850,64.1,28.6,0.5,0.5,1.1,5.2
E08000027,DUDLEY,146883,146735,99.2,89.4,0.8,0.0,0.0,0.1,0.7,0.2,99.5,0.3,0.0,145687,131338,1216,1,15,85,1048,344,146122,383,0,14349,131338,1,14,70,963,9.8,89.4,0.0,0.0,0.0,0.7
S12000006,DUMFRIES AND GALLOWAY,81954,81175,84.5,4.8,4.8,1.8,4.2,7.4,14.5,8.5,95.6,0.0,0.0,69268,3935,3935,1514,3452,6028,11907,6937,78375,0,0,65333,3935,1514,1938,2576,5879,79.7,4.8,1.8,2.4,3.1,7.2
S12000042,DUNDEE CITY,79309,79291,98.5,84.8,0.6,0.0,0.0,0.3,1.5,0.4,99.1,0.0,0.0,78128,67229,498,1,10,235,1163,305,78575,0,0,10899,67229,1,9,225,928,13.7,84.8,0.0,0.0,0.3,1.2
E09000009,EALING,147585,147483,98.4,70.9,13.3,0.0,0.0,0.4,1.6,0.6,98.4,0.0,0.0,145194,104705,19643,0,63,544,2289,894,145249,0,0,40489,104705,0,63,481,1745,27.4,70.9,0.0,0.0,0.3,1.2
S12000008,EAST AYRSHIRE,59099,59049,94.4,37.2,10.9,0.6,1.4,2.9,5.5,3.1,97.6,0.0,0.0,55786,21973,6459,340,814,1720,3263,1825,57672,0,0,33813,21973,340,474,906,1543,57.2,37.2,0.6,0.8,1.5,2.6
E07000009,EAST CAMBRIDGESHIRE,39339,39253,93.9,30.8,3.6,0.5,1.2,2.1,5.9,2.4,98.9,30.7,26.3,36922,12111,1402,214,455,829,2331,938,38923,12064,10361,24811,12111,214,241,374,1502,63.1,30.8,0.5,0.6,1.0,3.8
E07000040,EAST DEVON,73920,73845,87.2,8.8,5.7,0.6,2.6,5.2,12.7,5.8,95.4,19.1,0.7,64461,6510,4185,433,1903,3879,9384,4293,70529,14107,516,57951,6510,433,1470,1976,5505,78.4,8.8,0.6,2.0,2.7,7.4
S12000045,EAST DUNBARTONSHIRE,49414,49367,96.4,74.9,11.1,0.1,0.2,0.6,3.5,0.7,98.5,0.0,0.0,47636,37026,5466,39,89,272,1731,337,48661,0,0,10610,37026,39,50,183,1459,21.5,74.9,0.1,0.1,0.4,3.0
E07000085,EAST HAMPSHIRE,57316,57036,91.9,34.1,6.3,0.2,0.7,1.6,7.6,2.3,97.1,0.0,0.0,52684,19520,3589,132,427,895,4352,1301,55654,0,0,33164,19520,132,295,468,3457,57.9,34.1,0.2,0.5,0.8,6.0
E07000242,EAST HERTFORDSHIRE,66180,66147,94.0,64.0,4.9,0.1,0.7,1.4,5.9,1.6,97.0,0.0,0.0,62217,42334,3255,95,461,907,3930,1046,64209,0,0,19883,42334,95,366,446,3023,30.0,64.0,0.1,0.6,0.7,4.6
E07000137,EAST LINDSEY,72085,71841,86.9,14.0,2.6,1.0,3.1,5.5,12.8,6.0,97.2,11.0,5.2,62647,10106,1876,724,2245,3991,9194,4296,70091,7949,3723,52541,10106,724,1521,1746,5203,72.9,14.0,1.0,2.1,2.4,7.2
S12000010,EAST LOTHIAN,48656,48593,92.5,11.9,14.6,0.4,1.4,2.4,7.4,2.7,97.6,27.1,26.7,45005,5794,7105,184,684,1182,3588,1310,47509,13208,12979,39211,5794,184,500,498,2406,80.6,11.9,0.4,1.0,1.0,4.9
E07000152,EAST NORTHAMPTONSHIRE,42934,42907,97.2,45.7,11.3,0.1,0.4,0.6,2.8,0.7,98.8,0.0,0.0,41711,19618,4861,28,159,261,1196,306,42407,1,0,22093,19618,28,131,102,935,51.5,45.7,0.1,0.3,0.2,2.2
S12000011,EAST RENFREWSHIRE,40891,40880,95.7,68.8,3.8,0.2,0.4,0.7,4.2,1.0,98.7,0.0,0.0,39147,28127,1558,96,161,294,1733,409,40348,0,0,11020,28127,96,65,133,1439,26.9,68.8,0.2,0.2,0.3,3.5
E06000011,EAST RIDING OF YORKSHIRE,164889,163976,94.0,42.2,41.2,0.5,1.0,1.7,5.4,2.4,97.2,32.3,25.1,155069,69552,67924,774,1631,2759,8907,3981,160264,53196,41452,85517,69552,774,857,1128,6148,51.9,42.2,0.5,0.5,0.7,3.7
E07000193,EAST STAFFORDSHIRE,55351,55231,94.4,28.0,23.7,0.2,0.8,1.6,5.4,1.8,98.7,0.0,0.0,52261,15505,13124,126,424,873,2970,1023,54626,0,0,36756,15505,126,298,449,2097,66.4,28.0,0.2,0.5,0.8,3.8
E07000244,EAST SUFFOLK,126099,125911,92.8,11.7,6.3,0.3,1.0,2.0,7.0,2.3,97.7,0.0,0.0,117081,14693,7915,352,1262,2468,8830,2915,123159,0,0,102388,14693,352,910,1206,6362,81.2,11.7,0.3,0.7,1.0,5.0
E07000061,EASTBOURNE,50597,50580,98.9,2.1,2.1,0.0,0.0,0.1,1.1,0.1,99.4,0.0,0.0,50033,1039,1039,0,6,54,547,71,50314,0,0,48994,1039,0,6,48,493,96.8,2.1,0.0,0.0,0.1,1.0
E07000086,EASTLEIGH,59912,59830,97.2,63.7,8.0,0.0,0.0,0.1,2.7,0.3,99.0,0.0,0.0,58224,38140,4778,0,0,69,1606,172,59301,0,0,20084,38140,0,0,69,1537,33.5,63.7,0.0,0.0,0.1,2.6
E07000030,EDEN,29583,29434,80.7,3.6,3.6,4.2,8.1,11.2,18.8,11.9,94.9,4.8,4.2,23866,1059,1059,1250,2386,3309,5568,3529,28073,1419,1248,22807,1059,1250,1136,923,2259,77.1,3.6,4.2,3.8,3.1,7.6
E07000207,ELMBRIDGE,60416,60333,98.6,75.5,3.3,0.0,0.0,0.1,1.2,0.3,99.7,0.0,0.0,59580,45623,2007,9,25,65,753,152,60212,0,0,13957,45623,9,16,40,688,23.1,75.5,0.0,0.0,0.1,1.1
E09000010,ENFIELD,132646,131424,96.9,79.1,2.3,0.0,0.1,0.7,2.2,1.7,97.2,0.0,0.0,128490,104968,3008,21,126,870,2934,2264,128952,0,0,23522,104968,21,105,744,2064,17.7,79.1,0.0,0.1,0.6,1.6
E07000072,EPPING FOREST,61279,61210,93.5,74.2,8.6,0.1,0.4,1.3,6.3,1.6,95.8,0.0,0.0,57325,45470,5244,68,244,818,3885,957,58707,0,0,11855,45470,68,176,574,3067,19.3,74.2,0.1,0.3,0.9,5.0
E07000208,EPSOM AND EWELL,33139,33134,99.2,79.8,3.0,0.0,0.1,0.2,0.8,0.2,99.4,0.0,0.0,32879,26429,995,0,46,57,255,63,32950,0,0,6450,26429,0,46,11,198,19.5,79.8,0.0,0.1,0.0,0.6
E07000036,EREWASH,55617,55547,98.0,74.3,0.8,0.1,0.4,0.5,1.9,0.6,99.4,0.0,0.0,54491,41331,451,77,206,289,1056,360,55283,0,0,13160,41331,77,129,83,767,23.7,74.3,0.1,0.2,0.1,1.4
E07000041,EXETER,58192,58117,95.3,82.1,46.2,0.0,0.2,1.8,4.5,2.3,95.9,46.4,12.7,55472,47771,26910,29,119,1026,2645,1347,55820,27004,7413,7701,47771,29,90,907,1619,13.2,82.1,0.0,0.2,1.6,2.8
S12000014,FALKIRK,73734,73697,96.9,79.8,2.4,0.1,0.4,1.0,3.1,1.2,98.5,0.0,0.0,71417,58869,1738,61,331,730,2280,858,72661,0,0,12548,58869,61,270,399,1550,17.0,79.8,0.1,0.4,0.5,2.1
E07000087,FAREHAM,52658,52602,98.4,82.3,3.7,0.0,0.2,0.5,1.5,0.6,99.4,0.0,0.0,51810,43363,1960,8,91,239,792,300,52366,0,0,8447,43363,8,83,148,553,16.0,82.3,0.0,0.2,0.3,1.1
E07000010,FENLAND,47680,47632,94.0,50.7,26.5,0.4,1.1,1.9,5.9,2.1,98.5,5.8,0.8,44817,24180,12640,205,533,905,2815,981,46962,2786,359,20637,24180,205,328,372,1910,43.3,50.7,0.4,0.7,0.8,4.0
N09000006,FERMANAGH AND OMAGH,50051,49188,69.0,16.8,16.8,7.9,13.6,18.6,29.3,20.4,97.0,40.0,9.4,34528,8403,8403,3932,6822,9326,14660,10213,48548,20025,4704,26125,8403,3932,2890,2504,5334,52.2,16.8,7.9,5.8,5.0,10.7
S12000047,FIFE,189725,189463,95.2,41.8,17.1,0.2,0.8,1.6,4.6,1.8,98.8,0.0,0.0,180711,79318,32520,445,1423,2943,8752,3345,187420,0,0,101393,79318,445,978,1520,5809,53.4,41.8,0.2,0.5,0.8,3.1
W06000005,FLINTSHIRE,73684,73588,93.2,14.9,9.9,0.4,1.1,2.5,6.7,2.8,97.5,32.5,9.2,68654,10976,7297,276,845,1843,4934,2028,71813,23934,6807,57678,10976,276,569,998,3091,78.3,14.9,0.4,0.8,1.4,4.2
E07000112,FOLKESTONE AND HYTHE,54227,54182,93.3,37.9,1.9,0.5,1.2,2.3,6.6,2.5,97.9,0.0,0.0,50611,20531,1056,256,628,1250,3571,1348,53104,0,0,30080,20531,256,372,622,2321,55.5,37.9,0.5,0.7,1.1,4.3
E07000080,FOREST OF DEAN,41478,41397,78.6,14.4,12.6,0.6,3.2,8.4,21.2,9.9,88.0,12.5,5.3,32615,5991,5238,255,1338,3497,8782,4122,36497,5185,2197,26624,5991,255,1083,2159,5285,64.2,14.4,0.6,2.6,5.2,12.7
E07000119,FYLDE,36896,36663,93.1,32.1,3.8,0.1,0.5,1.1,6.3,1.8,97.6,7.7,3.3,34350,11849,1388,20,187,399,2313,656,35994,2837,1225,22501,11849,20,167,212,1914,61.0,32.1,0.1,0.5,0.6,5.2
E08000037,GATESHEAD,100365,100193,95.6,64.2,3.6,0.0,0.3,1.3,4.2,1.7,97.1,0.0,0.0,95980,64421,3565,47,286,1272,4213,1690,97483,1,0,31559,64421,47,239,986,2941,31.4,64.2,0.0,0.2,1.0,2.9
E07000173,GEDLING,54875,54855,99.1,88.0,32.0,0.0,0.2,0.3,0.9,0.3,99.8,0.0,0.0,54357,48316,17557,26,130,158,498,178,54772,0,0,6041,48316,26,104,28,340,11.0,88.0,0.0,0.2,0.1,0.6
S12000049,GLASGOW CITY,335016,334530,96.8,58.9,8.6,0.0,0.1,0.3,3.0,0.6,97.2,0.0,0.0,324359,197201,28747,57,177,1123,10171,1952,325678,0,0,127158,197201,57,120,946,9048,38.0,58.9,0.0,0.0,0.3,2.7
E07000081,GLOUCESTER,59662,59650,98.0,83.5,5.5,0.0,0.1,0.6,2.0,1.1,98.3,49.8,2.1,58447,49828,3286,1,71,337,1203,643,58671,29697,1256,8619,49828,1,70,266,866,14.4,83.5,0.0,0.1,0.4,1.5
E07000088,GOSPORT,38811,38799,99.8,85.7,1.0,0.0,0.0,0.0,0.1,0.1,99.9,0.0,0.0,38749,33248,406,1,9,9,50,21,38789,0,0,5501,33248,1,8,0,41,14.2,85.7,0.0,0.0,0.0,0.1
E07000109,GRAVESHAM,45061,45046,95.9,63.9,6.4,0.0,0.4,0.8,4.1,0.8,98.5,0.0,0.0,43208,28808,2876,17,189,350,1838,365,44395,0,0,14400,28808,17,172,161,1488,32.0,63.9,0.0,0.4,0.4,3.3
E07000145,GREAT YARMOUTH,49002,48852,96.3,49.6,2.6,0.0,0.2,0.5,3.4,0.9,99.0,0.0,0.0,47186,24307,1254,15,114,259,1666,423,48515,0,0,22879,24307,15,99,145,1407,46.7,49.6,0.0,0.2,0.3,2.9
E09000011,GREENWICH,124726,124569,97.9,76.7,12.6,0.0,0.1,0.8,1.9,1.0,98.1,0.0,0.0,122151,95639,15713,0,178,947,2418,1234,122319,0,0,26512,95639,0,178,769,1471,21.3,76.7,0.0,0.1,0.6,1.2
E07000209,GUILDFORD,58309,58291,96.2,64.9,2.9,0.0,0.2,0.6,3.7,0.7,99.3,0.0,0.0,56111,37870,1692,24,110,362,2180,393,57891,0,0,18241,37870,24,86,252,1818,31.3,64.9,0.0,0.1,0.4,3.1
W06000002,GWYNEDD,67960,67694,86.9,15.0,14.1,1.5,3.6,6.2,12.7,6.8,93.4,11.4,4.2,59051,10168,9565,1003,2435,4218,8643,4645,63489,7735,2823,48883,10168,1003,1432,1783,4425,71.9,15.0,1.5,2.1,2.6,6.5
E09000012,HACKNEY,124421,124032,97.2,69.6,10.4,0.0,0.0,0.2,2.5,0.5,97.2,0.0,0.0,120876,86567,12928,0,0,229,3156,642,120910,0,0,34309,86567,0,0,229,2927,27.6,69.6,0.0,0.0,0.2,2.4
E06000006,HALTON,61942,61778,97.8,63.4,1.8,0.0,0.1,0.4,2.0,0.7,99.2,0.0,0.0,60566,39267,1088,18,83,229,1212,407,61473,8,0,21299,39267,18,65,146,983,34.4,63.4,0.0,0.1,0.2,1.6
E07000164,HAMBLETON,44139,44069,87.6,4.7,4.6,1.5,3.8,6.5,12.2,7.0,97.4,41.1,25.1,38674,2061,2041,664,1687,2870,5395,3094,42986,18134,11085,36613,2061,664,1023,1183,2525,82.9,4.7,1.5,2.3,2.7,5.7
E09000013,HAMMERSMITH AND FULHAM,92335,92181,94.1,54.6,18.1,0.0,0.1,0.2,5.7,0.4,94.1,0.0,0.0,86910,50374,16730,0,66,213,5271,372,86928,0,0,36536,50374,0,66,147,5058,39.6,54.6,0.0,0.1,0.2,5.5
E07000131,HARBOROUGH,42619,42563,94.7,34.2,11.9,0.3,0.7,1.5,5.1,1.7,98.5,0.0,0.0,40377,14582,5071,127,284,626,2186,705,41998,0,0,25795,14582,127,157,342,1560,60.5,34.2,0.3,0.4,0.8,3.7
E09000014,HARINGEY,108080,108022,98.3,82.5,2.4,0.0,0.1,0.3,1.7,0.5,98.4,0.0,0.0,106211,89206,2545,0,76,350,1811,573,106307,0,0,17005,89206,0,76,274,1461,15.7,82.5,0.0,0.1,0.3,1.4
E07000073,HARLOW,40971,40944,96.7,81.0,3.5,0.0,0.0,0.5,3.2,0.6,96.9,0.0,0.0,39628,33172,1420,1,8,197,1316,266,39702,0,0,6456,33172,1,7,189,1119,15.8,81.0,0.0,0.0,0.5,2.7
E07000165,HARROGATE,77465,77380,90.9,52.6,3.9,0.8,2.4,3.6,9.0,3.9,97.2,13.1,5.8,70377,40711,3046,650,1888,2824,7003,3028,75273,10159,4456,29666,40711,650,1238,936,4179,38.3,52.6,0.8,1.6,1.2,5.4
E09000015,HARROW,98381,97934,97.3,76.5,11.8,0.0,0.0,0.5,2.3,1.2,97.4,0.0,0.0,95702,75306,11589,14,46,502,2232,1172,95795,0,0,20396,75306,14,32,456,1730,20.7,76.5,0.0,0.0,0.5,1.8
E07000089,HART,43888,43634,94.4,58.6,5.7,0.1,0.8,1.3,5.1,1.9,98.1,0.0,0.0,41415,25705,2508,23,363,583,2219,855,43045,0,0,15710,25705,23,340,220,1636,35.8,58.6,0.1,0.8,0.5,3.7
E06000001,HARTLEPOOL,47156,47116,96.3,84.2,0.5,0.3,0.6,1.2,3.6,1.4,96.9,1.3,0.0,45431,39699,222,119,260,549,1685,664,45695,597,4,5732,39699,119,141,289,1136,12.2,84.2,0.3,0.3,0.6,2.4
E07000062,HASTINGS,46043,46012,98.2,0.9,0.9,0.0,0.0,0.0,1.7,0.1,99.8,0.0,0.0,45225,411,411,0,5,9,787,40,45962,0,0,44814,411,0,5,4,778,97.3,0.9,0.0,0.0,0.0,1.7
E07000090,HAVANT,57669,57562,99.1,85.9,1.0,0.0,0.0,0.1,0.7,0.3,99.5,0.0,0.0,57166,49564,560,0,1,76,396,183,57369,0,0,7602,49564,0,1,75,320,13.2,85.9,0.0,0.0,0.1,0.6
E09000016,HAVERING,113579,112216,95.7,82.1,4.0,0.0,0.2,0.5,3.1,1.8,96.6,0.0,0.0,108747,93214,4501,53,180,557,3469,2039,109697,0,0,15533,93214,53,127,377,2912,13.7,82.1,0.0,0.1,0.3,2.6
E06000019,"HEREFORDSHIRE, COUNTY OF",89841,89594,85.5,16.2,13.3,1.0,3.2,5.8,14.2,6.3,94.2,18.0,6.1,76811,14530,11919,918,2847,5230,12783,5701,84589,16158,5470,62281,14530,918,1929,2383,7553,69.3,16.2,1.0,2.1,2.7,8.4
E07000098,HERTSMERE,46140,46124,98.0,79.6,2.7,0.0,0.2,0.4,1.9,0.5,99.1,0.0,0.0,45235,36709,1238,5,106,181,889,213,45741,0,0,8526,36709,5,101,75,708,18.5,79.6,0.0,0.2,0.2,1.5
E07000037,HIGH PEAK,45923,45744,91.6,6.8,3.3,0.4,1.3,2.1,8.0,2.6,98.7,0.0,0.0,42070,3114,1532,203,590,980,3674,1180,45326,0,0,38956,3114,203,387,390,2694,84.8,6.8,0.4,0.8,0.8,5.9
S12000017,HIGHLAND,114693,112658,80.2,2.4,2.4,2.3,4.6,8.2,18.0,10.2,93.2,8.3,1.7,91968,2776,2776,2583,5238,9367,20690,11665,106918,9520,1944,89192,2776,2583,2655,4129,11323,77.8,2.4,2.3,2.3,3.6,9.9
E09000017,HILLINGDON,120139,119385,96.0,83.6,5.0,0.0,0.2,0.8,3.3,1.7,96.4,0.0,0.0,115371,100483,6045,44,257,904,4014,2083,115833,0,0,14888,100483,44,213,647,3110,12.4,83.6,0.0,0.2,0.5,2.6
E07000132,HINCKLEY AND BOSWORTH,55024,54418,95.3,60.8,8.3,0.1,0.9,1.4,3.6,2.5,97.6,0.0,0.0,52436,33457,4561,44,509,757,1982,1367,53717,0,0,18979,33457,44,465,248,1225,34.5,60.8,0.1,0.8,0.5,2.2
E07000227,HORSHAM,66433,66378,93.0,17.9,9.0,0.3,1.0,1.8,6.9,2.0,98.7,0.0,0.0,61791,11910,5990,210,682,1212,4587,1303,65574,0,0,49881,11910,210,472,530,3375,75.1,17.9,0.3,0.7,0.8,5.1
E09000018,HOUNSLOW,100250,100085,97.6,84.0,10.4,0.0,0.1,0.4,2.2,0.6,97.7,0.0,0.0,97874,84234,10475,0,121,407,2211,622,97983,0,0,13640,84234,0,121,286,1804,13.6,84.0,0.0,0.1,0.3,1.8
E07000011,HUNTINGDONSHIRE,82455,82059,96.0,51.7,5.0,0.3,0.7,1.3,3.5,1.8,98.9,0.4,0.0,79164,42665,4123,231,602,1075,2895,1507,81509,316,0,36499,42665,231,371,473,1820,44.3,51.7,0.3,0.4,0.6,2.2
E07000120,HYNDBURN,41003,40908,97.6,58.2,0.9,0.0,0.1,0.2,2.2,0.5,99.0,43.7,23.4,40009,23851,354,18,43,91,899,187,40583,17920,9597,16158,23851,18,25,48,808,39.4,58.2,0.0,0.1,0.1,2.0
S12000018,INVERCLYDE,42007,41931,97.1,71.9,8.6,0.1,0.3,0.6,2.8,0.8,98.4,0.0,0.0,40772,30219,3611,41,124,258,1159,354,41354,0,0,10553,30219,41,83,134,901,25.1,71.9,0.1,0.2,0.3,2.1
E07000202,IPSWICH,65045,64966,98.5,82.9,1.5,0.0,0.1,0.3,1.4,0.5,98.7,0.0,0.0,64078,53941,985,0,39,223,888,304,64208,0,0,10137,53941,0,39,184,665,15.6,82.9,0.0,0.1,0.3,1.0
W06000001,ISLE OF ANGLESEY,36957,36817,88.5,15.1,15.1,0.8,2.4,4.1,11.2,4.8,95.4,22.5,7.0,32690,5596,5596,284,891,1524,4127,1775,35268,8311,2569,27094,5596,284,607,633,2603,73.3,15.1,0.8,1.6,1.7,7.0
E06000046,ISLE OF WIGHT,78201,78014,94.3,0.9,17.7,0.3,0.7,1.3,5.5,1.5,99.5,0.0,0.0,73749,675,13852,244,579,1016,4265,1203,77813,0,0,73074,675,244,335,437,3249,93.4,0.9,0.3,0.4,0.6,4.2
E06000053,ISLES OF SCILLY,1685,1675,94.4,0.0,0.0,0.0,0.0,0.2,5.0,0.8,99.4,0.0,0.0,1590,0,0,0,0,4,85,14,1675,0,0,1590,0,0,0,4,81,94.4,0.0,0.0,0.0,0.2,4.8
E09000019,ISLINGTON,121956,121910,94.5,76.5,10.1,0.0,0.0,0.0,5.5,0.2,94.5,0.0,0.0,115229,93299,12287,0,0,15,6681,245,115234,0,0,21930,93299,0,0,15,6666,18.0,76.5,0.0,0.0,0.0,5.5
E09000020,KENSINGTON AND CHELSEA,99270,99230,94.9,79.6,7.3,0.0,0.0,0.1,5.1,0.2,94.9,0.0,0.0,94159,78998,7233,0,0,52,5071,151,94159,0,0,15161,78998,0,0,52,5019,15.3,79.6,0.0,0.0,0.1,5.1
E07000153,KETTERING,48741,48351,95.2,46.8,7.1,0.1,0.8,1.6,4.0,2.6,96.0,0.1,0.0,46393,22815,3455,44,382,761,1958,1272,46772,34,0,23578,22815,44,338,379,1197,48.4,46.8,0.1,0.7,0.8,2.5
E07000146,"KING'S LYNN AND WEST NORFOLK",78883,78332,91.0,6.2,3.1,0.4,1.2,2.4,8.3,3.2,97.7,3.0,0.4,71781,4897,2414,312,968,1920,6551,2552,77092,2396,323,66884,4897,312,656,952,4631,84.8,6.2,0.4,0.8,1.2,5.9
E06000010,"KINGSTON UPON HULL, CITY OF",127670,126290,98.2,97.0,97.0,0.0,0.0,0.1,0.8,1.3,98.2,21.3,12.0,125326,123847,123847,4,21,190,964,1703,125326,27158,15320,1479,123847,4,17,169,774,1.2,97.0,0.0,0.0,0.1,0.6
E09000021,KINGSTON UPON THAMES,70788,70709,97.0,85.2,2.7,0.0,0.1,0.2,2.9,0.4,97.8,0.0,0.0,68652,60303,1897,9,46,129,2057,314,69197,0,0,8349,60303,9,37,83,1928,11.8,85.2,0.0,0.1,0.1,2.7
E08000034,KIRKLEES,195994,195933,97.0,63.4,11.1,0.0,0.3,0.7,3.0,0.7,98.8,0.1,0.0,190149,124260,21826,82,498,1289,5784,1463,193556,164,0,65889,124260,82,416,791,4495,33.6,63.4,0.0,0.2,0.4,2.3
E08000011,KNOWSLEY,72457,72345,98.6,73.8,4.5,0.0,0.2,0.3,1.3,0.4,99.4,3.3,0.0,71437,53449,3286,23,135,205,908,326,72012,2391,0,17988,53449,23,112,70,703,24.8,73.8,0.0,0.2,0.1,1.0
E09000022,LAMBETH,155958,155636,95.5,68.3,9.5,0.0,0.0,0.0,4.3,0.2,95.7,0.0,0.0,148973,106468,14809,0,0,3,6663,351,149243,0,0,42505,106468,0,0,3,6660,27.3,68.3,0.0,0.0,0.0,4.3
E07000121,LANCASTER,67983,67953,98.2,49.4,11.6,0.2,0.3,0.6,1.8,0.7,99.7,0.5,0.0,66748,33568,7890,143,220,387,1205,442,67796,348,10,33180,33568,143,77,167,818,48.8,49.4,0.2,0.1,0.2,1.2
E08000035,LEEDS,374780,374594,96.3,80.2,33.9,0.0,0.3,0.6,3.7,0.8,97.1,4.7,0.6,360899,300741,126899,176,1188,2323,13695,2875,364014,17781,2335,60158,300741,176,1012,1135,11372,16.1,80.2,0.0,0.3,0.3,3.0
E06000016,LEICESTER,144734,144651,99.1,88.4,6.3,0.0,0.0,0.2,0.9,0.3,99.2,0.0,0.0,143402,127936,9105,2,31,283,1249,497,143595,0,0,15466,127936,2,29,252,966,10.7,88.4,0.0,0.0,0.2,0.7
E07000063,LEWES,47277,47251,96.8,20.7,22.0,0.1,0.3,0.6,3.2,0.7,99.8,0.0,0.0,45749,9778,10424,50,141,284,1502,312,47174,0,0,35971,9778,50,91,143,1218,76.1,20.7,0.1,0.2,0.3,2.6
E09000023,LEWISHAM,137562,137424,96.0,64.5,13.5,0.0,0.0,0.2,3.9,0.5,96.2,0.0,0.0,132077,88789,18546,0,0,263,5347,622,132317,0,0,43288,88789,0,0,263,5084,31.5,64.5,0.0,0.0,0.2,3.7
E07000194,LICHFIELD,48563,48526,95.8,64.2,5.4,0.3,0.7,1.3,4.1,1.4,99.6,0.0,0.0,46524,31183,2615,167,328,639,2002,685,48354,0,0,15341,31183,167,161,311,1363,31.6,64.2,0.3,0.3,0.6,2.8
E07000138,LINCOLN,48177,48132,98.3,79.9,0.5,0.0,0.1,0.5,1.6,0.6,98.5,23.9,20.8,47338,38472,239,12,30,248,794,294,47450,11531,10022,8866,38472,12,18,218,546,18.4,79.9,0.0,0.0,0.5,1.1
N09000007,LISBURN AND CASTLEREAGH,60787,60338,92.5,67.7,46.2,0.3,1.5,2.4,6.7,3.2,98.4,0.0,0.0,56248,41130,28075,209,882,1448,4090,1941,59803,0,0,15118,41130,209,673,566,2642,24.9,67.7,0.3,1.1,0.9,4.3
E08000012,LIVERPOOL,236001,235798,94.7,77.2,26.4,0.0,0.0,0.2,5.2,0.4,95.0,0.0,0.0,223461,182084,62281,3,41,546,12337,1054,224107,117,0,41377,182084,3,38,505,11791,17.5,77.2,0.0,0.0,0.2,5.0
E06000032,LUTON,86460,86398,99.2,92.4,3.7,0.0,0.2,0.2,0.7,0.3,99.3,0.0,0.0,85778,79864,3162,6,166,206,620,279,85829,0,0,5914,79864,6,160,40,414,6.8,92.4,0.0,0.2,0.0,0.5
E07000110,MAIDSTONE,76815,76707,91.9,49.9,5.1,0.5,1.6,2.8,7.9,3.0,97.5,0.0,0.0,70621,38326,3886,366,1211,2132,6086,2276,74871,0,0,32295,38326,366,845,921,3954,42.0,49.9,0.5,1.1,1.2,5.1
E07000074,MALDON,29816,29746,92.3,7.4,7.4,0.3,1.0,2.2,7.5,2.5,98.9,0.0,0.0,27511,2206,2206,97,303,666,2235,757,29483,0,0,25305,2206,97,206,363,1569,84.9,7.4,0.3,0.7,1.2,5.3
E07000235,MALVERN HILLS,37989,37934,87.5,11.6,7.1,0.7,2.6,5.1,12.4,5.5,96.7,33.3,15.2,33227,4422,2716,255,993,1924,4707,2078,36723,12665,5771,28805,4422,255,738,931,2783,75.8,11.6,0.7,1.9,2.5,7.3
E08000003,MANCHESTER,246753,246642,94.1,64.5,16.1,0.1,0.2,1.1,5.9,1.6,94.5,2.1,0.6,232149,159038,39759,164,467,2803,14493,3891,233113,5107,1461,73111,159038,164,303,2336,11690,29.6,64.5,0.1,0.1,0.9,4.7
E07000174,MANSFIELD,52577,52559,99.0,82.3,8.8,0.0,0.1,0.2,1.0,0.2,99.6,0.0,0.0,52026,43293,4637,5,35,84,533,109,52387,0,0,8733,43293,5,30,49,449,16.6,82.3,0.0,0.1,0.1,0.9
E06000035,MEDWAY,121257,121150,97.1,73.4,1.6,0.0,0.3,0.7,2.8,0.9,98.6,0.0,0.0,117799,89060,1979,25,318,892,3351,1142,119611,0,0,28739,89060,25,293,574,2459,23.7,73.4,0.0,0.2,0.5,2.0
E07000133,MELTON,24617,24545,93.6,46.0,1.9,0.8,1.9,3.1,6.1,3.6,97.1,2.4,1.3,23039,11335,456,192,466,763,1506,896,23899,593,328,11704,11335,192,274,297,743,47.5,46.0,0.8,1.1,1.2,3.0
E07000187,MENDIP,55476,55360,83.9,26.4,3.6,0.7,2.7,6.1,15.9,6.7,93.7,0.2,0.2,46558,14659,1984,369,1503,3376,8802,3728,52003,115,115,31899,14659,369,1134,1873,5426,57.5,26.4,0.7,2.0,3.4,9.8
W06000024,MERTHYR TYDFIL,28414,28391,96.5,2.4,2.4,0.1,0.2,0.4,3.4,0.5,99.7,17.3,7.3,27420,685,685,40,69,113,971,137,28337,4916,2085,26735,685,40,29,44,858,94.1,2.4,0.1,0.1,0.2,3.0
E09000024,MERTON,89533,89507,98.4,83.7,24.0,0.0,0.0,0.2,1.6,0.6,98.4,0.0,0.0,88074,74909,21458,1,38,188,1433,504,88101,0,0,13165,74909,1,37,150,1245,14.7,83.7,0.0,0.0,0.2,1.4
N09000008,MID AND EAST ANTRIM,61576,60984,89.2,40.2,43.8,1.9,3.5,4.8,9.8,5.8,97.9,0.0,0.0,54932,24765,26987,1161,2133,2937,6052,3557,60254,0,0,30167,24765,1161,972,804,3115,49.0,40.2,1.9,1.6,1.3,5.1
E07000042,MID DEVON,37154,37020,78.2,4.2,4.2,1.9,5.8,10.7,21.4,11.4,91.9,7.6,3.7,29063,1578,1576,722,2145,3969,7957,4237,34145,2839,1386,27485,1578,722,1423,1824,3988,74.0,4.2,1.9,3.8,4.9,10.7
E07000203,MID SUFFOLK,48559,48453,89.9,8.9,8.2,0.6,1.3,2.7,9.9,3.0,97.9,0.0,0.0,43652,4337,3995,291,633,1321,4801,1453,47523,0,0,39315,4337,291,342,688,3480,81.0,8.9,0.6,0.7,1.4,7.2
E07000228,MID SUSSEX,69237,68866,94.6,20.3,17.3,0.1,0.3,0.9,4.9,1.4,99.0,0.0,0.0,65487,14025,12004,53,207,594,3379,969,68577,0,0,51462,14025,53,154,387,2785,74.3,20.3,0.1,0.2,0.6,4.0
N09000009,MID ULSTER,55426,54667,77.1,12.9,12.9,3.5,6.9,10.4,21.5,11.8,97.5,4.5,1.4,42737,7171,7171,1943,3799,5763,11930,6562,54042,2494,774,35566,7171,1943,1856,1964,6167,64.2,12.9,3.5,3.3,3.5,11.1
E06000002,MIDDLESBROUGH,67405,67388,96.4,89.4,0.9,0.1,0.6,1.1,3.6,1.4,96.7,0.9,0.0,64992,60232,638,66,383,735,2396,937,65162,614,23,4760,60232,66,317,352,1661,7.1,89.4,0.1,0.5,0.5,2.5
S12000019,MIDLOTHIAN,40209,40028,93.0,27.9,29.5,0.6,1.5,2.8,6.5,3.2,97.5,3.8,3.8,37403,11207,11849,242,594,1110,2625,1297,39223,1512,1512,26196,11207,242,352,516,1515,65.1,27.9,0.6,0.9,1.3,3.8
E06000042,MILTON KEYNES,120985,120859,97.3,58.6,54.9,0.1,0.5,1.2,2.6,1.4,98.6,0.0,0.0,117691,70938,66375,84,593,1461,3168,1727,119255,0,0,46753,70938,84,509,868,1707,38.6,58.6,0.1,0.4,0.7,1.4
E07000210,MOLE VALLEY,39719,39692,95.0,55.6,5.4,0.0,0.3,0.8,5.0,0.9,99.3,0.0,0.0,37724,22093,2159,18,103,308,1968,347,39456,0,0,15631,22093,18,85,205,1660,39.4,55.6,0.0,0.2,0.5,4.2
W06000021,MONMOUTHSHIRE,45402,45284,85.9,14.4,7.6,1.4,3.3,6.0,13.8,6.5,96.1,1.0,0.0,38997,6535,3449,626,1504,2744,6287,2951,43612,440,1,32462,6535,626,878,1240,3543,71.5,14.4,1.4,1.9,2.7,7.8
S12000020,MORAY,49142,48776,84.0,2.9,2.9,1.6,4.5,7.2,15.2,8.2,95.3,0.0,0.0,41285,1401,1401,791,2222,3522,7491,4048,46809,0,0,39884,1401,791,1431,1300,3969,81.2,2.9,1.6,2.9,2.6,8.1
S12000013,NA H-EILEANAN SIAR,16433,15049,74.1,2.8,2.8,2.8,4.6,6.4,17.4,15.1,87.7,0.0,0.0,12184,463,463,465,763,1048,2865,2476,14408,0,0,11721,463,465,298,285,1817,71.3,2.8,2.8,1.8,1.7,11.1
W06000012,NEATH PORT TALBOT,68808,68774,97.0,57.8,2.7,0.1,0.3,0.5,3.0,0.7,99.2,15.3,7.5,66743,39796,1832,102,228,362,2031,489,68229,10498,5152,26947,39796,102,126,134,1669,39.2,57.8,0.1,0.2,0.2,2.4
E07000091,NEW FOREST,87032,86928,93.1,23.3,9.7,0.5,1.0,1.7,6.8,1.9,98.9,0.0,0.0,81024,20247,8462,458,836,1466,5904,1626,86086,0,0,60777,20247,458,378,630,4438,69.8,23.3,0.5,0.4,0.7,5.1
E07000175,NEWARK AND SHERWOOD,58896,58773,95.6,51.5,11.4,0.3,0.9,1.4,4.2,1.6,98.8,0.0,0.0,56290,30320,6739,185,557,799,2483,943,58202,13,0,25970,30320,185,372,242,1684,44.1,51.5,0.3,0.6,0.4,2.9
E08000021,NEWCASTLE UPON TYNE,145247,145055,95.3,59.0,5.1,0.0,0.1,0.2,4.6,0.4,95.9,0.0,0.0,138386,85729,7429,16,82,336,6669,575,139357,0,0,52657,85729,16,66,254,6333,36.3,59.0,0.0,0.0,0.2,4.4
E07000195,NEWCASTLE-UNDER-LYME,60587,60447,96.4,64.7,10.9,0.0,0.3,0.7,3.3,1.0,98.9,1.8,0.4,58432,39218,6634,21,178,427,2015,598,59943,1068,237,19214,39218,21,157,249,1588,31.7,64.7,0.0,0.3,0.4,2.6
E09000025,NEWHAM,127209,126973,97.2,80.0,16.4,0.0,0.1,0.8,2.6,1.2,97.2,0.0,0.0,123645,101825,20820,3,74,1053,3328,1509,123661,0,0,21820,101825,3,71,979,2275,17.2,80.0,0.0,0.1,0.8,1.8
W06000022,NEWPORT,72530,72479,97.1,67.2,4.3,0.1,0.4,0.9,2.8,1.1,98.0,38.2,8.2,70442,48728,3123,74,268,642,2037,815,71104,27675,5975,21714,48728,74,194,374,1395,29.9,67.2,0.1,0.3,0.5,1.9
N09000010,"NEWRY, MOURNE AND DOWN",70690,69279,82.3,6.7,6.7,2.8,5.3,7.6,15.8,9.6,97.3,5.0,0.6,58143,4755,4755,2003,3736,5372,11136,6821,68757,3502,409,53388,4755,2003,1733,1636,5764,75.5,6.7,2.8,2.5,2.3,8.2
S12000021,NORTH AYRSHIRE,71797,71730,93.9,29.2,9.0,0.4,0.9,1.9,6.0,2.1,98.8,0.0,0.0,67413,20975,6440,311,671,1381,4317,1492,70958,0,0,46438,20975,311,360,710,2936,64.7,29.2,0.4,0.5,1.0,4.1
E07000043,NORTH DEVON,50755,50644,85.7,3.0,3.0,1.4,3.6,7.3,14.1,8.0,93.5,15.9,4.3,43508,1526,1526,688,1851,3726,7136,4068,47480,8076,2172,41982,1526,688,1163,1875,3410,82.7,3.0,1.4,2.3,3.7,6.7
E07000038,NORTH EAST DERBYSHIRE,48262,48231,90.9,21.9,20.4,0.4,1.3,2.7,9.0,3.1,98.0,0.0,0.0,43872,10546,9844,173,646,1310,4359,1473,47319,0,0,33326,10546,173,473,664,3049,69.1,21.9,0.4,1.0,1.4,6.3
E06000012,NORTH EAST LINCOLNSHIRE,73898,73831,97.0,87.8,0.5,0.1,0.8,1.3,2.9,1.6,97.7,25.9,19.7,71698,64901,385,69,602,925,2133,1192,72195,19137,14541,6797,64901,69,533,323,1208,9.2,87.8,0.1,0.7,0.4,1.6
E07000099,NORTH HERTFORDSHIRE,60706,60646,95.7,69.5,1.9,0.1,0.5,1.2,4.2,1.4,97.9,0.0,0.0,58085,42164,1145,53,286,746,2561,845,59445,0,0,15921,42164,53,233,460,1815,26.2,69.5,0.1,0.4,0.8,3.0
E07000139,NORTH KESTEVEN,54368,54297,93.5,33.8,3.3,0.7,1.4,2.2,6.3,2.5,97.8,4.9,3.1,50847,18393,1815,360,768,1206,3450,1382,53199,2654,1675,32454,18393,360,408,438,2244,59.7,33.8,0.7,0.8,0.8,4.1
S12000050,NORTH LANARKSHIRE,163937,163850,97.8,73.9,7.5,0.1,0.3,0.6,2.1,0.7,99.1,0.0,0.0,160369,121117,12228,82,516,1061,3481,1194,162384,0,0,39252,121117,82,434,545,2420,23.9,73.9,0.1,0.3,0.3,1.5
E06000013,NORTH LINCOLNSHIRE,80423,80265,93.7,40.8,1.6,0.7,1.3,2.1,6.1,2.3,97.3,52.0,43.9,75347,32849,1279,535,1041,1655,4918,1860,78219,41855,35276,42498,32849,535,506,614,3263,52.8,40.8,0.7,0.6,0.8,4.1
E07000147,NORTH NORFOLK,60151,60065,89.6,3.2,3.2,0.6,2.1,3.5,10.3,3.7,97.4,0.1,0.1,53877,1904,1898,332,1265,2118,6188,2245,58605,61,61,51973,1904,332,933,853,4070,86.4,3.2,0.6,1.6,1.4,6.8
E06000024,NORTH SOMERSET,103411,102665,90.5,32.0,8.8,0.3,1.0,2.3,8.8,3.2,95.6,0.0,0.0,93571,33106,9119,287,991,2396,9094,3284,98910,0,0,60465,33106,287,704,1405,6698,58.5,32.0,0.3,0.7,1.4,6.5
E08000022,NORTH TYNESIDE,101970,101762,98.2,62.5,1.0,0.0,0.1,0.5,1.6,0.7,99.1,0.0,0.0,100135,63728,983,22,148,474,1627,721,101050,0,0,36407,63728,22,126,326,1153,35.7,62.5,0.0,0.1,0.3,1.1
E07000218,NORTH WARWICKSHIRE,30136,30091,95.2,23.4,8.7,0.4,1.1,1.7,4.6,1.9,99.3,0.0,0.0,28698,7049,2630,114,331,500,1393,563,29919,0,0,21649,7049,114,217,169,893,71.8,23.4,0.4,0.7,0.6,3.0
E07000134,NORTH WEST LEICESTERSHIRE,47936,47893,95.4,63.0,3.8,0.1,0.8,1.4,4.5,1.5,99.0,0.0,0.0,45752,30212,1824,63,384,653,2141,728,47435,0,0,15540,30212,63,321,269,1488,32.4,63.0,0.1,0.7,0.6,3.1
E07000154,NORTHAMPTON,107472,104720,95.3,67.8,3.9,0.0,0.3,0.6,2.1,3.4,95.6,1.2,0.0,102440,72875,4172,16,351,634,2280,3664,102694,1258,5,29565,72875,16,335,283,1646,27.5,67.8,0.0,0.3,0.3,1.5
E06000057,NORTHUMBERLAND,155874,155560,92.9,7.6,3.8,0.9,1.8,2.6,6.9,2.9,98.5,5.4,0.6,144741,11793,5971,1376,2746,4088,10819,4571,153551,8480,888,132948,11793,1376,1370,1342,6731,85.3,7.6,0.9,0.9,0.9,4.3
E07000148,NORWICH,59035,58537,98.0,81.4,0.2,0.0,0.0,0.5,1.2,1.4,98.1,0.0,0.0,57829,48048,96,0,6,283,708,807,57888,0,0,9781,48048,0,6,277,425,16.6,81.4,0.0,0.0,0.5,0.7
E06000018,NOTTINGHAM,149314,149251,97.0,88.0,10.6,0.0,0.2,0.4,3.0,0.5,97.2,0.0,0.0,144833,131435,15898,3,312,602,4418,783,145059,0,0,13398,131435,3,309,290,3816,9.0,88.0,0.0,0.2,0.2,2.6
E07000219,NUNEATON AND BEDWORTH,60779,60759,99.0,75.8,3.6,0.0,0.1,0.2,1.0,0.3,99.6,0.0,0.0,60150,46086,2194,10,75,128,609,158,60524,0,0,14064,46086,10,65,53,481,23.1,75.8,0.0,0.1,0.1,0.8
E07000135,OADBY AND WIGSTON,25356,25301,98.8,76.3,2.4,0.0,0.0,0.1,1.0,0.5,99.1,0.0,0.0,25040,19341,606,0,4,21,261,130,25130,0,0,5699,19341,0,4,17,240,22.5,76.3,0.0,0.0,0.1,0.9
E08000004,OLDHAM,98405,98292,98.2,74.0,8.8,0.1,0.2,0.3,1.7,0.4,99.6,0.0,0.0,96612,72851,8646,57,151,320,1680,438,98024,0,0,23761,72851,57,94,169,1360,24.1,74.0,0.1,0.1,0.2,1.4
S12000023,ORKNEY ISLANDS,12728,12207,63.7,0.6,0.6,4.1,9.6,20.9,32.2,25.4,76.2,0.0,0.0,8106,79,79,526,1220,2656,4101,3236,9695,0,0,8027,79,526,694,1436,1445,63.1,0.6,4.1,5.5,11.3,11.4
E07000178,OXFORD,66611,66513,97.4,80.2,1.8,0.0,0.0,0.4,2.4,0.6,97.6,0.0,0.0,64904,53415,1193,0,29,260,1609,432,64983,0,0,11489,53415,0,29,231,1349,17.2,80.2,0.0,0.0,0.3,2.0
W06000009,PEMBROKESHIRE,65509,65401,87.0,5.2,5.2,1.7,4.1,6.9,12.9,7.5,94.8,5.0,2.1,56963,3410,3409,1140,2708,4539,8438,4912,62094,3263,1352,53553,3410,1140,1568,1831,3899,81.7,5.2,1.7,2.4,2.8,6.0
E07000122,PENDLE,43591,43537,96.0,52.3,1.3,0.4,0.9,1.2,3.8,1.4,99.0,57.4,21.3,41866,22793,580,170,393,543,1671,610,43138,25013,9288,19073,22793,170,223,150,1128,43.8,52.3,0.4,0.5,0.3,2.6
S12000048,PERTH AND KINROSS,78184,77774,84.7,32.1,1.8,1.6,4.1,7.4,14.7,8.3,94.8,0.0,0.0,66247,25117,1415,1243,3215,5812,11527,6527,74140,0,0,41130,25117,1243,1972,2597,5715,52.6,32.1,1.6,2.5,3.3,7.3
E06000031,PETERBOROUGH,91317,91229,97.7,72.9,31.2,0.1,0.3,0.5,2.2,0.7,98.8,0.0,0.0,89196,66575,28511,88,298,494,2033,629,90192,0,0,22621,66575,88,210,196,1539,24.8,72.9,0.1,0.2,0.2,1.7
E06000026,PLYMOUTH,125537,125153,96.6,85.2,1.3,0.0,0.2,0.9,3.1,1.4,96.9,19.2,2.9,121213,106917,1665,2,225,1144,3940,1722,121645,24054,3629,14296,106917,2,223,919,2796,11.4,85.2,0.0,0.2,0.7,2.2
E06000044,PORTSMOUTH,96333,95921,96.3,90.7,4.3,0.0,0.3,0.7,3.3,1.3,96.5,0.0,0.0,92782,87333,4164,1,277,677,3139,1298,92944,0,0,5449,87333,1,276,400,2462,5.7,90.7,0.0,0.3,0.4,2.6
W06000023,POWYS,69158,68200,76.8,15.4,15.4,3.5,7.5,12.7,21.8,14.5,87.8,10.1,2.1,53137,10629,10627,2445,5174,8767,15063,10054,60732,7014,1462,42508,10629,2445,2729,3593,6296,61.5,15.4,3.5,3.9,5.2,9.1
E07000123,PRESTON,68251,68103,97.4,66.7,4.0,0.0,0.1,0.5,2.4,0.8,98.5,61.3,51.5,66466,45506,2741,27,53,364,1637,533,67225,41812,35147,20960,45506,27,26,311,1273,30.7,66.7,0.0,0.0,0.5,1.9
E06000038,READING,76298,76218,98.4,84.9,9.8,0.0,0.1,0.2,1.5,0.5,98.7,0.0,0.0,75108,64803,7503,3,80,145,1110,351,75270,0,0,10305,64803,3,77,65,965,13.5,84.9,0.0,0.1,0.1,1.3
E09000026,REDBRIDGE,110074,109984,98.0,86.1,15.9,0.0,0.1,0.2,1.9,0.4,98.2,0.0,0.0,107890,94733,17545,14,68,258,2094,452,108145,0,0,13157,94733,14,54,190,1836,12.0,86.1,0.0,0.0,0.2,1.7
E06000003,REDCAR AND CLEVELAND,67932,67906,96.4,84.9,0.9,0.2,0.6,1.5,3.6,1.8,97.8,0.4,0.0,65489,57651,587,116,437,996,2417,1216,66441,277,0,7838,57651,116,321,559,1421,11.5,84.9,0.2,0.5,0.8,2.1
E07000236,REDDITCH,39273,39239,98.4,77.9,1.8,0.0,0.0,0.1,1.5,0.2,99.1,2.6,1.4,38648,30589,706,2,14,40,591,81,38918,1029,545,8059,30589,2,12,26,551,20.5,77.9,0.0,0.0,0.1,1.4
E07000211,REIGATE AND BANSTEAD,63902,63881,97.7,70.3,3.1,0.0,0.1,0.2,2.3,0.3,99.7,0.0,0.0,62412,44946,2010,14,72,144,1469,177,63738,0,0,17466,44946,14,58,72,1325,27.3,70.3,0.0,0.1,0.1,2.1
S12000038,RENFREWSHIRE,94377,94342,96.7,72.6,9.4,0.1,0.3,0.7,3.2,1.0,98.3,0.0,0.0,91300,68534,8887,69,288,632,3042,924,92749,0,0,22766,68534,69,219,344,2410,24.1,72.6,0.1,0.2,0.4,2.6
W06000016,RHONDDA CYNON TAF,118686,118445,97.4,14.1,3.7,0.0,0.1,0.5,2.4,0.8,99.0,21.3,10.9,115627,16710,4365,55,122,586,2818,1007,117552,25338,12990,98917,16710,55,67,464,2232,83.3,14.1,0.0,0.1,0.4,1.9
E07000124,RIBBLE VALLEY,29823,29788,89.8,11.5,8.2,0.7,2.4,4.2,10.1,4.4,98.6,61.0,20.8,26788,3434,2460,215,709,1264,3000,1312,29392,18193,6189,23354,3434,215,494,555,1736,78.3,11.5,0.7,1.7,1.9,5.8
E09000027,RICHMOND UPON THAMES,88910,88813,97.8,81.9,14.4,0.0,0.0,0.3,2.0,0.5,98.0,0.0,0.0,86997,72843,12787,1,18,273,1816,438,87125,0,0,14154,72843,1,17,255,1543,15.9,81.9,0.0,0.0,0.3,1.7
E07000166,RICHMONDSHIRE,25446,25349,83.6,11.4,4.0,2.4,5.0,8.5,16.0,9.0,95.9,35.0,19.7,21279,2907,1014,607,1266,2173,4070,2298,24393,8908,5010,18372,2907,607,659,907,1897,72.2,11.4,2.4,2.6,3.6,7.5
E08000005,ROCHDALE,100860,100741,97.9,63.8,8.7,0.0,0.1,0.3,2.0,0.5,99.4,0.0,0.0,98726,64398,8814,22,97,304,2015,462,100240,0,0,34328,64398,22,75,207,1711,34.0,63.8,0.0,0.1,0.2,1.7
E07000075,ROCHFORD,37623,37516,95.7,9.7,5.3,0.0,0.2,0.5,4.0,0.8,99.0,0.0,0.0,35996,3633,1984,2,57,198,1520,311,37239,0,0,32363,3633,2,55,141,1322,86.0,9.7,0.0,0.1,0.4,3.5
E07000125,ROSSENDALE,34814,34678,95.1,43.2,0.8,0.1,0.7,0.9,4.6,1.3,98.8,5.6,5.5,33091,15026,275,26,249,326,1587,467,34404,1966,1900,18065,15026,26,223,77,1261,51.9,43.2,0.1,0.6,0.2,3.6
E07000064,ROTHER,49202,49062,92.7,3.6,3.6,0.1,0.4,1.3,7.0,1.6,99.4,0.0,0.0,45621,1771,1771,56,190,646,3441,793,48884,0,0,43850,1771,56,134,456,2795,89.1,3.6,0.1,0.3,0.9,5.7
E08000018,ROTHERHAM,123995,123883,98.2,58.5,8.3,0.0,0.3,0.6,1.7,0.7,99.3,0.4,0.2,121716,72482,10244,41,324,693,2167,876,123073,527,216,49234,72482,41,283,369,1474,39.7,58.5,0.0,0.2,0.3,1.2
E07000220,RUGBY,50136,50057,96.0,58.6,6.7,0.4,0.7,1.1,3.8,1.5,98.2,0.0,0.0,48141,29356,3359,185,327,573,1916,735,49245,0,0,18785,29356,185,142,246,1343,37.5,58.6,0.4,0.3,0.5,2.7
E07000212,RUNNYMEDE,38399,38370,96.7,66.8,2.8,0.0,0.0,0.7,3.3,0.7,98.4,0.0,0.0,37121,25642,1058,0,19,251,1249,282,37802,0,0,11479,25642,0,19,232,998,29.9,66.8,0.0,0.0,0.6,2.6
E07000176,RUSHCLIFFE,53713,53649,96.9,68.4,4.4,0.2,0.4,0.8,3.0,1.0,99.4,1.3,0.1,52057,36744,2347,89,215,450,1592,533,53384,716,58,15313,36744,89,126,235,1142,28.5,68.4,0.2,0.2,0.4,2.1
E07000092,RUSHMOOR,42463,42448,97.5,80.8,3.4,0.1,0.8,1.4,2.4,1.5,97.7,0.0,0.0,41410,34315,1462,42,326,595,1038,636,41483,0,0,7095,34315,42,284,269,443,16.7,80.8,0.1,0.7,0.6,1.0
E06000017,RUTLAND,18539,18516,93.4,11.3,11.3,0.3,0.5,0.8,6.5,0.9,99.4,0.0,0.0,17318,2091,2091,53,90,148,1198,173,18425,0,0,15227,2091,53,37,58,1050,82.1,11.3,0.3,0.2,0.3,5.7
E07000167,RYEDALE,30050,29770,82.6,6.9,6.9,3.2,5.9,8.7,16.5,9.8,94.2,22.2,12.5,24825,2062,2062,966,1773,2627,4945,2958,28318,6672,3771,22763,2062,966,807,854,2318,75.8,6.9,3.2,2.7,2.8,7.7
E08000006,SALFORD,127551,127474,96.0,81.1,54.9,0.0,0.5,1.7,3.9,2.2,96.2,1.8,0.0,122448,103467,70000,13,604,2160,5026,2831,122659,2236,0,18981,103467,13,591,1556,2866,14.9,81.1,0.0,0.5,1.2,2.2
E08000028,SANDWELL,141607,141520,99.3,74.3,4.0,0.0,0.0,0.2,0.6,0.3,99.4,0.0,0.0,140605,105222,5616,4,21,342,915,486,140751,0,0,35383,105222,4,17,321,573,25.0,74.3,0.0,0.0,0.2,0.4
E07000168,SCARBOROUGH,63096,63038,93.0,2.2,2.2,0.6,1.4,2.0,6.9,2.3,97.0,4.0,0.0,58679,1413,1410,391,853,1256,4359,1433,61224,2508,24,57266,1413,391,462,403,3103,90.8,2.2,0.6,0.7,0.6,4.9
S12000026,SCOTTISH BORDERS,61327,60796,85.6,6.2,4.1,1.7,4.2,7.5,13.5,8.8,95.0,14.6,0.6,52507,3832,2533,1020,2578,4597,8289,5409,58235,8949,381,48675,3832,1020,1558,2019,3692,79.4,6.2,1.7,2.5,3.3,6.0
E07000188,SEDGEMOOR,59064,59002,91.1,12.4,4.6,0.7,1.8,3.1,8.8,3.6,96.8,0.0,0.0,53823,7350,2741,438,1039,1822,5179,2154,57154,0,0,46473,7350,438,601,783,3357,78.7,12.4,0.7,1.0,1.3,5.7
E08000014,SEFTON,135018,134865,98.3,64.2,10.0,0.0,0.1,0.3,1.6,0.4,99.4,0.2,0.0,132683,86744,13441,46,178,362,2182,532,134232,219,0,45939,86744,46,132,184,1820,34.0,64.2,0.0,0.1,0.1,1.3
E07000169,SELBY,42689,42619,89.3,11.5,11.5,0.9,1.8,2.9,10.5,3.2,96.5,15.0,13.9,38117,4890,4888,382,765,1222,4502,1376,41213,6393,5918,33227,4890,382,383,457,3280,77.8,11.5,0.9,0.9,1.1,7.7
E07000111,SEVENOAKS,53115,53079,91.5,28.0,4.0,0.3,0.6,1.4,8.4,1.5,99.3,0.0,0.0,48620,14855,2121,134,339,759,4459,817,52731,0,0,33765,14855,134,205,420,3700,63.6,28.0,0.3,0.4,0.8,7.0
E08000019,SHEFFIELD,271375,271143,95.0,44.9,3.1,0.0,0.1,0.5,5.0,0.8,96.1,0.0,0.0,257699,121798,8281,76,248,1389,13444,2160,260822,0,0,135901,121798,76,172,1141,12055,50.1,44.9,0.0,0.1,0.4,4.4
S12000027,SHETLAND ISLANDS,11148,10815,69.0,0.6,0.6,3.5,7.9,17.5,28.0,20.7,83.2,0.0,0.0,7693,71,71,393,881,1954,3122,2309,9272,0,0,7622,71,393,488,1073,1168,68.4,0.6,3.5,4.4,9.6,10.5
E06000051,SHROPSHIRE,152374,151872,86.9,12.4,4.8,0.9,3.0,5.7,12.8,6.3,96.0,41.7,15.8,132399,18969,7375,1364,4529,8745,19473,9671,146246,63559,24133,113430,18969,1364,3165,4216,10728,74.4,12.4,0.9,2.1,2.8,7.0
E06000039,SLOUGH,57444,57361,98.7,84.6,5.1,0.0,0.1,0.3,1.2,0.5,98.9,0.0,0.0,56699,48589,2912,7,43,167,662,260,56835,0,0,8110,48589,7,36,124,495,14.1,84.6,0.0,0.1,0.2,0.9
E08000029,SOLIHULL,96819,96761,97.0,80.0,15.1,0.0,0.3,1.1,3.0,1.2,97.9,0.0,0.0,93904,77498,14637,23,270,1018,2857,1152,94806,0,0,16406,77498,23,247,748,1839,16.9,80.0,0.0,0.3,0.8,1.9
E07000246,SOMERSET WEST AND TAUNTON,77209,77054,88.8,12.0,3.7,0.9,2.8,5.2,11.0,5.8,95.8,3.2,1.4,68563,9271,2860,728,2151,4001,8491,4459,73984,2459,1065,59292,9271,728,1423,1850,4490,76.8,12.0,0.9,1.8,2.4,5.8
S12000028,SOUTH AYRSHIRE,58815,58728,93.8,56.2,0.9,0.4,1.2,2.7,6.0,3.0,98.2,0.0,0.0,55184,33040,548,227,731,1579,3544,1757,57753,0,0,22144,33040,227,504,848,1965,37.7,56.2,0.4,0.9,1.4,3.3
E07000006,SOUTH BUCKS,31243,31233,90.5,37.7,13.5,0.0,0.6,2.3,9.5,2.6,97.0,0.0,0.0,28265,11786,4205,14,201,714,2968,825,30317,0,0,16479,11786,14,187,513,2254,52.7,37.7,0.0,0.6,1.6,7.2
E07000012,SOUTH CAMBRIDGESHIRE,70241,70203,95.3,52.4,13.0,0.2,0.5,1.4,4.7,1.5,98.5,0.8,0.5,66926,36813,9145,150,378,978,3277,1064,69204,548,343,30113,36813,150,228,600,2299,42.9,52.4,0.2,0.3,0.9,3.3
E07000039,SOUTH DERBYSHIRE,47895,47774,92.6,22.0,11.9,0.3,1.3,2.1,7.1,2.5,98.5,0.0,0.0,44357,10517,5702,148,625,1001,3417,1217,47168,0,0,33840,10517,148,477,376,2416,70.7,22.0,0.3,1.0,0.8,5.0
E06000025,SOUTH GLOUCESTERSHIRE,125562,125457,97.9,73.1,8.2,0.1,0.3,0.7,2.1,0.9,99.3,0.0,0.0,122872,91801,10303,172,367,918,2585,1085,124624,0,0,31071,91801,172,195,551,1667,24.7,73.1,0.1,0.2,0.4,1.3
E07000044,SOUTH HAMS,48059,47926,80.8,16.2,12.3,0.8,2.9,7.3,18.9,8.2,93.9,25.7,16.1,38835,7797,5917,379,1413,3523,9091,3920,45110,12371,7719,31038,7797,379,1034,2110,5568,64.6,16.2,0.8,2.2,4.4,11.6
E07000140,SOUTH HOLLAND,43664,43547,88.0,7.2,5.7,0.4,1.9,3.6,11.7,3.9,98.4,0.5,0.5,38420,3162,2471,180,818,1559,5127,1685,42964,231,223,35258,3162,180,638,741,3568,80.7,7.2,0.4,1.5,1.7,8.2
E07000141,SOUTH KESTEVEN,68198,68142,92.8,29.4,2.6,0.6,1.1,1.9,7.1,2.2,98.0,0.0,0.0,63311,20022,1763,422,774,1318,4831,1478,66818,27,0,43289,20022,422,352,544,3513,63.5,29.4,0.6,0.5,0.8,5.2
E07000031,SOUTH LAKELAND,60098,60016,93.0,9.7,9.0,0.4,1.2,2.2,6.9,2.4,98.5,38.7,31.6,55867,5816,5396,269,708,1299,4149,1468,59176,23280,19016,50051,5816,269,439,591,2850,83.3,9.7,0.4,0.7,1.0,4.7
S12000029,SOUTH LANARKSHIRE,159202,159059,95.3,60.9,6.6,0.4,1.0,2.1,4.6,2.3,98.4,0.0,0.0,151776,97016,10501,655,1638,3373,7283,3613,156687,0,0,54760,97016,655,983,1735,3910,34.4,60.9,0.4,0.6,1.1,2.5
E07000149,SOUTH NORFOLK,65189,65116,88.6,7.8,3.2,0.4,1.9,3.6,11.3,3.9,97.2,0.0,0.0,57739,5057,2083,237,1223,2321,7377,2521,63396,0,0,52682,5057,237,986,1098,5056,80.8,7.8,0.4,1.5,1.7,7.8
E07000155,SOUTH NORTHAMPTONSHIRE,42438,42406,92.1,18.9,14.0,0.2,2.1,3.4,7.8,3.6,96.1,0.7,0.5,39088,8018,5954,73,909,1435,3318,1522,40770,281,199,31070,8018,73,836,526,1883,73.2,18.9,0.2,2.0,1.2,4.4
E07000179,SOUTH OXFORDSHIRE,65883,65816,95.6,35.7,12.9,0.1,0.4,0.8,4.3,0.9,99.6,0.0,0.0,62971,23522,8502,89,250,495,2845,583,65614,0,0,39449,23522,89,161,245,2350,59.9,35.7,0.1,0.2,0.4,3.6
E07000126,SOUTH RIBBLE,52666,52627,96.5,61.9,2.7,0.1,0.4,0.8,3.5,0.9,99.1,38.2,22.1,50799,32604,1416,34,195,436,1828,491,52183,20143,11619,18195,32604,34,161,241,1392,34.5,61.9,0.1,0.3,0.5,2.6
E07000189,SOUTH SOMERSET,83898,83465,87.6,1.6,1.5,0.5,2.6,4.8,11.8,5.5,96.8,4.3,4.3,73532,1367,1255,450,2223,3991,9933,4637,81208,3571,3571,72165,1367,450,1773,1768,5942,86.0,1.6,0.5,2.1,2.1,7.1
E07000196,SOUTH STAFFORDSHIRE,49732,49677,92.7,30.4,27.1,0.2,0.7,1.9,7.2,2.1,98.6,1.5,0.0,46114,15138,13472,84,348,955,3563,1031,49036,726,15,30976,15138,84,264,607,2608,62.3,30.4,0.2,0.5,1.2,5.2
E08000023,SOUTH TYNESIDE,75451,75441,97.7,70.7,0.5,0.1,0.3,0.6,2.3,0.7,98.7,0.0,0.0,73693,53339,404,46,228,419,1748,538,74449,0,0,20354,53339,46,182,191,1329,27.0,70.7,0.1,0.2,0.3,1.8
E06000045,SOUTHAMPTON,117108,116452,95.1,86.4,8.7,0.0,0.0,0.7,4.4,1.3,95.3,0.0,0.0,111337,101232,10213,0,32,777,5115,1498,111573,0,0,10105,101232,0,32,745,4338,8.6,86.4,0.0,0.0,0.6,3.7
E06000033,SOUTHEND-ON-SEA,86687,86527,96.1,60.2,4.0,0.0,0.0,0.0,3.7,0.6,96.6,0.0,0.0,83291,52180,3481,0,1,32,3236,495,83741,0,0,31111,52180,0,1,31,3204,35.9,60.2,0.0,0.0,0.0,3.7
E09000028,SOUTHWARK,149297,149123,91.9,70.5,33.5,0.0,0.0,0.3,8.0,0.7,92.0,0.0,0.0,137145,105280,50030,1,9,394,11978,1083,137335,0,0,31865,105280,1,8,385,11584,21.3,70.5,0.0,0.0,0.3,7.8
E07000213,SPELTHORNE,44542,44513,97.6,82.4,25.0,0.0,0.0,0.6,2.4,0.9,98.2,0.0,0.0,43466,36699,11125,0,6,263,1047,382,43740,0,0,6767,36699,0,6,257,784,15.2,82.4,0.0,0.0,0.6,1.8
E07000240,ST ALBANS,64302,64249,96.6,78.8,4.9,0.1,0.2,0.4,3.3,0.5,98.3,0.0,0.0,62136,50648,3139,58,109,249,2113,335,63216,0,0,11488,50648,58,51,140,1864,17.9,78.8,0.1,0.1,0.2,2.9
E08000013,ST. HELENS,87392,87358,97.8,81.6,2.7,0.1,0.4,0.6,2.1,0.7,99.3,17.2,0.9,85490,71285,2328,114,308,526,1868,595,86750,15039,752,14205,71285,114,194,218,1342,16.3,81.6,0.1,0.2,0.2,1.5
E07000197,STAFFORD,64751,64694,92.9,60.4,3.5,0.3,1.0,3.1,7.1,3.3,97.4,0.5,0.0,60129,39103,2269,168,666,2024,4565,2134,63050,322,4,21026,39103,168,498,1358,2541,32.5,60.4,0.3,0.8,2.1,3.9
E07000198,STAFFORDSHIRE MOORLANDS,46505,46453,91.8,26.0,1.7,0.7,1.7,3.8,8.1,4.0,98.3,0.0,0.0,42691,12104,776,316,811,1759,3762,1882,45696,0,0,30587,12104,316,495,948,2003,65.8,26.0,0.7,1.1,2.0,4.3
E07000243,STEVENAGE,39375,39335,99.2,86.2,1.1,0.0,0.1,0.2,0.7,0.3,99.3,0.0,0.0,39057,33952,436,0,29,60,278,105,39085,0,0,5105,33952,0,29,31,218,13.0,86.2,0.0,0.1,0.1,0.6
S12000030,STIRLING,46025,45680,88.3,31.7,27.7,1.4,3.1,5.0,11.0,5.9,95.9,0.0,0.0,40626,14610,12730,636,1423,2305,5054,2705,44126,0,0,26016,14610,636,787,882,2749,56.5,31.7,1.4,1.7,1.9,6.0
E08000007,STOCKPORT,139097,138953,98.5,81.3,1.0,0.0,0.1,0.2,1.4,0.3,99.1,10.9,0.0,136994,113116,1397,24,201,274,1959,485,137902,15122,0,23878,113116,24,177,73,1685,17.2,81.3,0.0,0.1,0.1,1.2
E06000004,STOCKTON-ON-TEES,91085,91048,95.8,84.3,4.0,0.1,0.5,1.6,4.2,2.1,96.4,12.0,2.2,87224,76817,3665,79,447,1500,3824,1938,87823,10919,2018,10407,76817,79,368,1053,2324,11.4,84.3,0.1,0.4,1.2,2.6
E06000021,STOKE-ON-TRENT,124572,124513,97.6,75.4,0.5,0.0,0.1,0.3,2.3,0.5,98.5,0.0,0.0,121595,93881,664,3,75,434,2918,620,122659,0,0,27714,93881,3,72,359,2484,22.2,75.4,0.0,0.1,0.3,2.0
E07000221,STRATFORD-ON-AVON,64840,64535,92.7,30.6,8.2,0.4,1.3,2.4,6.8,3.0,97.5,4.8,0.9,60106,19849,5317,259,820,1586,4429,1953,63192,3126,557,40257,19849,259,561,766,2843,62.1,30.6,0.4,0.9,1.2,4.4
E07000082,STROUD,56622,56576,89.1,14.8,11.5,0.4,1.7,3.0,10.8,3.5,94.6,5.2,0.7,50438,8391,6490,231,947,1672,6138,1969,53582,2957,402,42047,8391,231,716,725,4466,74.3,14.8,0.4,1.3,1.3,7.9
E08000024,SUNDERLAND,136650,136314,96.7,57.0,5.7,0.1,0.2,0.9,3.1,1.3,97.9,0.0,0.0,132085,77846,7856,113,340,1238,4229,1735,133752,0,0,54239,77846,113,227,898,2991,39.7,57.0,0.1,0.2,0.7,2.2
E07000214,SURREY HEATH,38328,38319,97.8,65.6,7.0,0.0,0.0,0.2,2.2,0.2,99.8,0.0,0.0,37487,25147,2680,1,17,64,832,77,38258,0,0,12340,25147,1,16,47,768,32.2,65.6,0.0,0.0,0.1,2.0
E09000029,SUTTON,87217,87153,97.9,80.0,2.2,0.0,0.0,0.3,2.0,0.5,98.2,0.0,0.0,85387,69788,1882,13,25,257,1766,436,85646,0,0,15599,69788,13,12,232,1509,17.9,80.0,0.0,0.0,0.3,1.7
E07000113,SWALE,66896,66654,93.0,31.5,1.8,0.2,0.9,2.0,6.6,2.5,98.4,0.0,0.0,62242,21040,1209,159,586,1353,4412,1672,65841,0,0,41202,21040,159,427,767,3059,61.6,31.5,0.2,0.6,1.1,4.6
W06000011,SWANSEA,118626,118334,97.3,72.2,18.8,0.1,0.3,0.6,2.4,1.0,98.2,19.1,10.4,115429,85607,22272,111,318,714,2905,1132,116546,22671,12338,29822,85607,111,207,396,2191,25.1,72.2,0.1,0.2,0.3,1.8
E06000030,SWINDON,101600,101579,91.9,76.3,8.8,0.0,0.9,2.4,8.1,2.9,92.2,0.0,0.0,93320,77471,8894,33,916,2392,8259,2941,93700,0,0,15849,77471,33,883,1476,5867,15.6,76.3,0.0,0.9,1.5,5.8
E08000008,TAMESIDE,115576,115296,97.0,51.8,12.7,0.0,0.0,0.1,2.8,0.4,99.4,0.0,0.0,112078,59905,14720,1,17,168,3218,452,114832,0,0,52173,59905,1,16,151,3050,45.1,51.8,0.0,0.0,0.1,2.6
E07000199,TAMWORTH,35385,35312,98.9,81.4,3.0,0.1,0.2,0.3,0.9,0.5,99.5,0.0,0.0,34998,28809,1047,40,60,95,314,194,35191,0,0,6189,28809,40,20,35,219,17.5,81.4,0.1,0.1,0.1,0.6
E07000215,TANDRIDGE,38422,38390,94.0,47.5,7.3,0.1,0.6,1.0,5.9,1.1,99.5,0.0,0.0,36124,18236,2804,46,212,377,2266,418,38237,0,0,17888,18236,46,166,165,1889,46.6,47.5,0.1,0.4,0.4,4.9
E07000045,TEIGNBRIDGE,66003,65870,87.5,28.5,2.6,0.5,1.7,4.0,12.3,4.4,95.0,24.7,8.1,57767,18837,1706,348,1154,2627,8103,2901,62705,16315,5364,38930,18837,348,806,1473,5476,59.0,28.5,0.5,1.2,2.2,8.3
E06000020,TELFORD AND WREKIN,81391,81309,97.7,75.9,2.8,0.1,0.2,0.4,2.2,0.5,99.1,18.2,2.8,79513,61791,2286,60,139,353,1796,445,80643,14813,2243,17722,61791,60,79,214,1443,21.8,75.9,0.1,0.1,0.3,1.8
E07000076,TENDRING,73710,73658,93.5,5.1,5.1,0.5,1.6,2.6,6.5,2.9,97.0,0.0,0.0,68898,3763,3754,393,1176,1928,4760,2117,71501,0,0,65135,3763,393,783,752,2832,88.4,5.1,0.5,1.1,1.0,3.8
E07000093,TEST VALLEY,58581,58517,93.1,61.7,12.5,0.2,0.9,2.2,6.8,2.4,98.6,0.0,0.0,54555,36167,7297,140,554,1311,3962,1411,57758,0,0,18388,36167,140,414,757,2651,31.4,61.7,0.2,0.7,1.3,4.5
E07000083,TEWKESBURY,46206,45884,90.0,53.4,23.7,0.3,1.6,3.0,9.3,4.4,91.8,8.5,1.3,41580,24665,10967,144,751,1382,4304,2012,42400,3909,593,16915,24665,144,607,631,2922,36.6,53.4,0.3,1.3,1.4,6.3
E07000114,THANET,72763,72568,96.9,43.0,43.0,0.0,0.5,1.3,2.9,1.6,99.3,0.0,0.0,70481,31289,31254,13,398,964,2087,1160,72223,0,0,39192,31289,13,385,566,1123,53.9,43.0,0.0,0.5,0.8,1.5
E07000102,THREE RIVERS,39351,39339,96.8,73.3,1.7,0.1,0.3,0.6,3.2,0.7,99.6,0.0,0.0,38094,28861,670,54,102,245,1245,260,39211,0,0,9233,28861,54,48,143,1000,23.5,73.3,0.1,0.1,0.4,2.5
E06000034,THURROCK,71695,71680,95.5,73.2,6.3,0.0,0.5,1.8,4.5,1.9,97.1,0.0,0.0,68480,52472,4485,28,327,1311,3200,1349,69615,0,0,16008,52472,28,299,984,1889,22.3,73.2,0.0,0.4,1.4,2.6
E07000115,TONBRIDGE AND MALLING,56895,56828,94.6,55.3,7.4,0.2,0.5,1.4,5.3,1.6,98.4,0.0,0.0,53808,31474,4194,122,285,792,3020,914,55994,0,0,22334,31474,122,163,507,2228,39.3,55.3,0.2,0.3,0.9,3.9
E06000027,TORBAY,78639,78303,94.1,58.1,17.9,0.0,0.0,0.5,5.5,1.0,96.0,1.6,0.0,74016,45657,14114,12,26,385,4287,797,75522,1271,0,28359,45657,12,14,359,3902,36.1,58.1,0.0,0.0,0.5,5.0
W06000020,TORFAEN,45709,45660,95.1,36.0,7.5,0.1,0.4,1.4,4.8,1.8,96.8,57.1,45.8,43472,16473,3433,52,160,637,2188,814,44243,26110,20939,26999,16473,52,108,477,1551,59.1,36.0,0.1,0.2,1.0,3.4
E07000046,TORRIDGE,34256,34118,81.3,3.3,3.3,2.7,7.3,11.5,18.3,12.3,92.6,27.2,14.4,27862,1133,1133,914,2504,3937,6256,4226,31705,9321,4916,26729,1133,914,1590,1433,2319,78.0,3.3,2.7,4.6,4.2,6.8
E09000030,TOWER HAMLETS,141507,140825,90.5,61.2,32.8,0.0,0.0,0.5,9.0,1.1,90.5,0.0,0.0,128107,86636,46425,0,28,728,12718,1541,128132,0,0,41471,86636,0,28,700,11990,29.3,61.2,0.0,0.0,0.5,8.5
E08000009,TRAFFORD,107494,107184,97.8,66.3,2.2,0.0,0.2,0.3,1.9,0.7,98.9,1.5,0.0,105138,71264,2386,52,245,357,2046,725,106351,1658,0,33874,71264,52,193,112,1689,31.5,66.3,0.0,0.2,0.1,1.6
E07000116,TUNBRIDGE WELLS,52221,52162,91.0,46.2,7.2,0.1,1.2,2.9,8.9,3.1,98.3,0.0,0.0,47529,24139,3771,61,622,1521,4633,1638,51320,0,0,23390,24139,61,561,899,3112,44.8,46.2,0.1,1.1,1.7,6.0
E07000077,UTTLESFORD,40000,39914,84.4,24.8,7.6,0.5,2.0,5.8,15.4,6.5,91.5,0.0,0.0,33752,9912,3031,196,817,2323,6162,2600,36612,0,0,23840,9912,196,621,1506,3839,59.6,24.8,0.5,1.6,3.8,9.6
W06000014,VALE OF GLAMORGAN,62163,62082,95.6,52.0,5.8,0.2,1.0,1.6,4.3,1.9,97.7,11.5,6.2,59430,32294,3612,149,611,983,2652,1188,60728,7121,3825,27136,32294,149,462,372,1669,43.7,52.0,0.2,0.7,0.6,2.7
E07000180,VALE OF WHITE HORSE,61240,61184,96.0,59.5,15.6,0.2,0.4,1.0,3.9,1.1,98.7,0.0,0.0,58769,36441,9554,101,251,590,2415,656,60417,0,0,22328,36441,101,150,339,1825,36.5,59.5,0.2,0.2,0.6,3.0
E08000036,WAKEFIELD,161252,160351,95.3,46.7,14.6,0.0,0.3,0.8,4.1,1.4,97.6,0.4,0.0,153728,75332,23622,68,561,1221,6623,2315,157458,632,0,78396,75332,68,493,660,5402,48.6,46.7,0.0,0.3,0.4,3.4
E08000030,WALSALL,119601,119527,98.4,71.8,10.8,0.0,0.0,0.6,1.6,0.7,99.0,0.0,0.0,117673,85847,12909,5,52,660,1854,802,118436,0,0,31826,85847,5,47,608,1194,26.6,71.8,0.0,0.0,0.5,1.0
E09000031,WALTHAM FOREST,109961,109435,96.5,87.1,18.9,0.0,0.0,0.5,3.0,1.3,96.5,0.0,0.0,106086,95817,20802,6,27,503,3349,1472,106162,0,0,10269,95817,6,21,476,2846,9.3,87.1,0.0,0.0,0.4,2.6
E09000032,WANDSWORTH,155423,155112,96.8,74.7,20.4,0.0,0.0,0.1,3.0,0.5,96.8,0.0,0.0,150435,116046,31639,0,14,192,4677,716,150466,0,0,34389,116046,0,14,178,4485,22.1,74.7,0.0,0.0,0.1,2.9
E06000007,WARRINGTON,98694,98511,97.0,67.0,1.2,0.0,0.1,0.2,2.8,0.4,99.3,0.6,0.0,95781,66168,1199,40,110,219,2730,426,97964,571,34,29613,66168,40,70,109,2511,30.0,67.0,0.0,0.1,0.1,2.5
E07000222,WARWICK,68734,68664,97.2,71.7,7.8,0.1,0.9,1.3,2.7,1.4,98.8,1.9,0.6,66794,49285,5335,100,603,870,1870,950,67897,1334,419,17509,49285,100,503,267,1000,25.5,71.7,0.1,0.7,0.4,1.5
E07000103,WATFORD,42038,42015,99.3,87.4,1.7,0.0,0.0,0.2,0.6,0.2,99.4,0.0,0.0,41755,36730,702,1,12,67,260,97,41791,0,0,5025,36730,1,11,55,193,12.0,87.4,0.0,0.0,0.1,0.5
E07000216,WAVERLEY,56043,56004,93.9,14.9,4.7,0.1,0.5,0.9,6.0,0.9,99.5,0.0,0.0,52639,8350,2610,79,287,481,3365,522,55752,0,0,44289,8350,79,208,194,2884,79.0,14.9,0.1,0.4,0.3,5.1
E07000065,WEALDEN,73391,73301,93.4,6.8,6.7,0.2,0.7,1.4,6.4,1.6,99.4,0.0,0.0,68574,4957,4917,155,535,1062,4727,1175,72950,0,0,63617,4957,155,380,527,3665,86.7,6.8,0.2,0.5,0.7,5.0
E07000156,WELLINGBOROUGH,37753,37732,97.3,41.8,3.8,0.0,0.5,0.9,2.7,1.0,99.0,14.1,13.9,36722,15783,1452,15,174,351,1010,390,37376,5339,5264,20939,15783,15,159,177,659,55.5,41.8,0.0,0.4,0.5,1.7
E07000241,WELWYN HATFIELD,49731,49718,97.0,72.2,5.9,0.0,0.1,0.4,3.0,0.4,99.3,0.0,0.0,48245,35908,2921,7,35,185,1473,200,49365,0,0,12337,35908,7,28,150,1288,24.8,72.2,0.0,0.1,0.3,2.6
E06000037,WEST BERKSHIRE,71903,71721,96.2,67.3,25.3,0.1,0.4,0.9,3.6,1.3,97.6,0.0,0.0,69144,48397,18226,51,303,640,2577,924,70197,0,0,20747,48397,51,252,337,1937,28.9,67.3,0.1,0.4,0.5,2.7
E07000047,WEST DEVON,26927,26863,78.0,7.5,7.5,1.8,6.1,11.8,21.8,12.3,95.2,41.2,18.9,21003,2021,2021,487,1644,3173,5860,3316,25636,11094,5083,18982,2021,487,1157,1529,2687,70.5,7.5,1.8,4.3,5.7,10.0
S12000039,WEST DUNBARTONSHIRE,47020,47002,98.3,88.2,0.5,0.0,0.2,0.5,1.6,0.6,99.0,0.0,0.0,46240,41480,232,15,98,229,762,289,46563,0,0,4760,41480,15,83,131,533,10.1,88.2,0.0,0.2,0.3,1.1
E07000127,WEST LANCASHIRE,51465,51432,94.4,26.5,19.9,0.2,0.8,1.7,5.5,1.9,98.7,17.3,5.8,48607,13614,10227,111,428,857,2825,962,50793,8910,2963,34993,13614,111,317,429,1968,68.0,26.5,0.2,0.6,0.8,3.8
E07000142,WEST LINDSEY,45800,45658,85.3,29.4,17.6,1.9,4.5,7.2,14.3,7.7,97.0,26.3,19.0,39087,13471,8056,871,2075,3296,6571,3517,44429,12066,8695,25616,13471,871,1204,1221,3275,55.9,29.4,1.9,2.6,2.7,7.2
S12000040,WEST LOTHIAN,85594,85541,96.4,56.7,14.0,0.2,0.4,0.8,3.6,0.9,98.9,0.0,0.0,82484,48495,11974,143,367,664,3057,764,84638,0,0,33989,48495,143,224,297,2393,39.7,56.7,0.2,0.3,0.3,2.8
E07000181,WEST OXFORDSHIRE,51638,51572,96.3,51.6,19.4,0.1,0.5,1.4,3.6,1.7,98.4,0.0,0.0,49719,26643,10026,66,265,730,1853,882,50793,0,0,23076,26643,66,199,465,1123,44.7,51.6,0.1,0.4,0.9,2.2
E07000245,WEST SUFFOLK,83907,83856,94.7,20.1,6.0,0.1,0.6,0.9,5.2,1.1,99.0,0.1,0.0,79490,16878,5051,124,465,791,4366,885,83067,119,0,62612,16878,124,341,326,3575,74.6,20.1,0.1,0.4,0.4,4.3
E09000033,WESTMINSTER,163531,163093,84.9,46.2,39.7,0.0,0.0,0.0,14.8,0.4,84.9,0.0,0.0,138890,75487,64925,0,0,50,24203,597,138909,0,0,63403,75487,0,0,50,24153,38.8,46.2,0.0,0.0,0.0,14.8
E08000010,WIGAN,152626,152595,98.7,81.7,2.2,0.0,0.1,0.3,1.3,0.3,99.6,15.2,0.8,150616,124727,3415,33,202,434,1979,497,151952,23172,1169,25889,124727,33,169,232,1545,17.0,81.7,0.0,0.1,0.2,1.0
E06000054,WILTSHIRE,231642,231458,93.3,37.5,12.8,0.3,0.9,1.9,6.6,2.1,98.5,1.0,1.0,216167,86869,29715,660,2157,4510,15291,4846,228083,2324,2324,129298,86869,660,1497,2353,10781,55.8,37.5,0.3,0.6,1.0,4.7
E07000094,WINCHESTER,56173,56110,91.1,41.8,6.1,0.4,1.4,2.7,8.8,2.9,97.7,0.0,0.0,51184,23464,3403,250,772,1509,4926,1621,54877,0,0,27720,23464,250,522,737,3417,49.3,41.8,0.4,0.9,1.3,6.1
E06000040,WINDSOR AND MAIDENHEAD,66690,66649,93.9,56.8,4.0,0.2,0.4,1.1,6.0,1.4,97.9,0.0,0.0,62632,37878,2639,142,285,734,4017,940,65316,0,0,24754,37878,142,143,449,3283,37.1,56.8,0.2,0.2,0.7,4.9
E08000015,WIRRAL,157758,157698,97.5,60.4,24.0,0.0,0.1,0.2,2.5,0.3,99.6,1.4,0.0,153794,95356,37879,35,122,322,3904,418,157071,2133,0,58438,95356,35,87,200,3582,37.0,60.4,0.0,0.1,0.1,2.3
E07000217,WOKING,45106,45084,98.1,81.8,3.4,0.0,0.3,0.4,1.9,0.4,99.2,0.0,0.0,44248,36898,1526,0,144,162,836,184,44760,0,0,7350,36898,0,144,18,674,16.3,81.8,0.0,0.3,0.0,1.5
E06000041,WOKINGHAM,75606,74585,92.1,64.4,8.8,0.0,0.2,1.0,6.5,2.9,95.2,0.0,0.0,69661,48704,6623,21,155,738,4924,2193,71984,0,0,20957,48704,21,134,583,4186,27.7,64.4,0.0,0.2,0.8,5.5
E08000031,WOLVERHAMPTON,118270,118064,98.1,87.3,1.1,0.0,0.0,0.1,1.8,0.3,98.3,0.0,0.0,115987,103279,1284,0,2,78,2077,327,116300,0,0,12708,103279,0,2,76,1999,10.7,87.3,0.0,0.0,0.1,1.7
E07000237,WORCESTER,48706,48657,98.6,10.1,1.6,0.0,0.0,0.0,1.3,0.1,99.5,43.0,4.6,48018,4925,759,0,1,10,639,60,48486,20934,2233,43093,4925,0,1,9,629,88.5,10.1,0.0,0.0,0.0,1.3
E07000229,WORTHING,51551,51531,99.2,86.4,2.4,0.0,0.0,0.0,0.7,0.1,99.5,0.0,0.0,51148,44546,1229,0,1,10,383,45,51290,0,0,6602,44546,0,1,9,373,12.8,86.4,0.0,0.0,0.0,0.7
W06000006,WREXHAM,65797,65169,93.7,30.9,31.0,0.3,1.1,2.0,5.4,3.2,96.9,38.9,8.4,61647,20315,20406,226,716,1343,3522,2123,63755,25576,5528,41332,20315,226,490,627,2179,62.8,30.9,0.3,0.7,1.0,3.3
E07000238,WYCHAVON,62385,61978,92.3,9.8,6.0,0.1,0.7,1.6,7.0,2.4,97.9,9.3,1.4,57611,6117,3744,86,425,1007,4367,1498,61045,5828,848,51494,6117,86,339,582,3360,82.5,9.8,0.1,0.5,0.9,5.4
E07000007,WYCOMBE,76760,76658,95.7,29.8,2.5,0.1,0.3,0.5,4.2,0.7,99.4,0.0,0.0,73424,22845,1930,76,230,402,3234,521,76307,0,0,50579,22845,76,154,172,2832,65.9,29.8,0.1,0.2,0.2,3.7
E07000128,WYRE,56428,56328,94.8,6.0,5.6,0.1,0.3,0.7,5.0,0.9,98.7,7.3,1.4,53500,3409,3169,63,179,374,2828,526,55688,4116,775,50091,3409,63,116,195,2454,88.8,6.0,0.1,0.2,0.3,4.3
E07000239,WYRE FOREST,48107,48058,96.7,45.9,1.3,0.2,0.5,1.0,3.2,1.1,99.5,2.9,0.4,46527,22105,622,78,224,461,1531,532,47862,1411,172,24422,22105,78,146,237,1070,50.8,45.9,0.2,0.3,0.5,2.2
E06000014,YORK,98071,97835,93.8,71.8,50.3,0.0,0.2,0.7,6.0,1.1,95.4,7.1,3.9,91949,70416,49307,35,187,674,5886,1106,93566,6962,3812,21533,70416,35,152,487,5212,22.0,71.8,0.0,0.2,0.5,5.3
