laua,laua_name,All Premises,All Matched Premises,SFBB availability (% premises),UFBB (100Mbit/s) availability (% premises),UFBB availability (% premises),Full Fibre availability (% premises),Gigabit availability (% premises),% of premises unable to receive 2Mbit/s,% of premises unable to receive 5Mbit/s,% of premises unable to receive 10Mbit/s,% of premises unable to receive 30Mbit/s,% of premises below the USO,% of premises with NGA,% of premises able to receive decent broadband from FWA,Number of premises with SFBB availability,Number of premises with UFBB (100Mbit/s) availability,Number of premises with UFBB availability,Number of premises with Full Fibre availability,Number of premises with Gigabit availability,Number of premises unable to receive 2Mbit/s,Number of premises unable to receive 5Mbit/s,Number of premises unable to receive 10Mbit/s,Number of premises unable to receive 30Mbit/s,Number of premises below the USO,Number of premises with NGA,Number of premises able to receive decent broadband from FWA,Number of premises with 30<300Mbit/s download speed,Number of premises with >=300Mbit/s download speed,Number of premises with 0<2Mbit/s download speed,Number of premises with 2<5Mbit/s download speed,Number of premises with 5<10Mbit/s download speed,Number of premises with 10<30Mbit/s download speed,% of premises with 30<300Mbit/s download speed,% of premises with >=300Mbit/s download speed,% of premises with 0<2Mbit/s download speed,% of premises with 2<5Mbit/s download speed,% of premises with 5<10Mbit/s download speed,% of premises with 10<30Mbit/s download speed
S12000033,ABERDEEN CITY,126709,126006,94.3,57.2,50.8,45.8,45.8,0.1,0.2,0.7,5.2,0.6,96.3,0.0,119437,72423,64379,57995,57995,68,223,945,6569,709,122024,0,55058,64379,68,155,722,5624,43.5,50.8,0.1,0.1,0.6,4.4
S12000034,ABERDEENSHIRE,126272,125269,82.8,8.7,8.5,8.4,8.4,2.6,5.8,9.4,16.4,3.6,94.4,0.0,104595,10928,10690,10550,10550,3306,7303,11829,20674,4605,119208,0,93905,10690,3306,3997,4526,8845,74.4,8.5,2.6,3.2,3.6,7.0
E07000223,ADUR,29838,29785,98.8,85.7,85.4,0.7,0.7,0.0,0.0,0.2,1.0,0.1,99.4,0.0,29474,25571,25492,213,213,1,13,47,311,38,29661,0,3982,25492,1,12,34,264,13.3,85.4,0.0,0.0,0.1,0.9
E07000026,ALLERDALE,51760,51513,92.5,3.1,3.1,3.1,3.1,1.2,2.2,3.2,7.0,1.2,98.5,2.2,47867,1617,1617,1617,1617,596,1121,1635,3646,635,50966,1159,46250,1617,596,525,514,2011,89.4,3.1,1.2,1.0,1.0,3.9
E07000032,AMBER VALLEY,61332,61041,95.3,30.8,27.3,24.2,24.2,0.1,0.3,0.7,4.2,0.5,98.8,0.0,58437,18894,16760,14868,14868,60,212,423,2604,304,60573,0,41677,16760,60,152,211,2181,68.0,27.3,0.1,0.2,0.3,3.6
S12000041,ANGUS,61112,60420,86.8,16.1,14.4,3.9,3.9,1.4,3.8,6.9,12.1,2.7,94.9,0.0,53039,9862,8772,2359,2359,878,2306,4204,7381,1672,58024,0,44267,8772,878,1428,1898,3177,72.4,14.4,1.4,2.3,3.1,5.2
N09000001,ANTRIM AND NEWTOWNABBEY,61030,60303,91.4,78.5,78.2,67.2,78.4,1.6,2.9,3.7,7.4,1.7,98.1,0.0,55782,47932,47737,41013,47872,968,1784,2248,4521,1045,59859,0,8045,47737,968,816,464,2273,13.2,78.2,1.6,1.3,0.8,3.7
N09000011,ARDS AND NORTH DOWN,72718,72484,94.9,75.8,75.5,74.1,75.8,0.6,1.1,2.1,4.8,0.8,99.5,0.0,68986,55108,54927,53913,55104,427,825,1517,3498,607,72331,0,14059,54927,427,398,692,1981,19.3,75.5,0.6,0.5,1.0,2.7
S12000035,ARGYLL AND BUTE,56456,54792,77.8,1.6,1.6,1.6,1.6,3.2,6.1,10.5,19.2,8.1,88.0,0.0,43933,886,886,885,886,1784,3416,5939,10859,4594,49709,0,43047,886,1784,1632,2523,4920,76.2,1.6,3.2,2.9,4.5,8.7
N09000002,"ARMAGH CITY, BANBRIDGE AND CRAIGAVON",86229,85733,88.6,65.8,64.9,65.8,65.8,1.5,3.1,4.7,10.9,2.0,98.3,0.2,76374,56698,55972,56697,56697,1274,2630,4072,9359,1759,84725,136,20402,55972,1274,1356,1442,5287,23.7,64.9,1.5,1.6,1.7,6.1
E07000224,ARUN,79056,78824,96.5,12.6,8.7,6.5,6.5,0.1,0.2,0.4,3.2,0.2,99.4,0.0,76285,9995,6908,5103,5103,94,152,294,2539,197,78606,0,69377,6908,94,58,142,2245,87.8,8.7,0.1,0.1,0.2,2.8
E07000170,ASHFIELD,59199,59077,98.2,87.4,86.2,3.9,3.9,0.0,0.3,0.4,1.5,0.3,99.0,0.0,58163,51720,51006,2320,2320,11,205,257,914,184,58623,0,7157,51006,11,194,52,657,12.1,86.2,0.0,0.3,0.1,1.1
E07000105,ASHFORD,58645,58326,89.7,48.1,45.1,7.8,7.8,0.4,1.9,3.8,9.7,1.1,97.8,0.0,52613,28228,26422,4564,4564,217,1142,2238,5713,657,57372,0,26191,26422,217,925,1096,3475,44.7,45.1,0.4,1.6,1.9,5.9
E07000200,BABERGH,43293,42985,93.6,14.6,14.3,10.2,10.2,0.4,0.8,1.2,5.7,0.8,98.6,0.0,40533,6318,6180,4420,4420,159,355,523,2452,356,42667,0,34353,6180,159,196,168,1929,79.4,14.3,0.4,0.5,0.4,4.5
E09000002,BARKING AND DAGENHAM,80515,80450,98.7,89.9,89.8,51.8,89.8,0.0,0.4,0.6,1.2,0.1,98.7,0.0,79474,72378,72321,41732,72312,22,291,461,976,54,79478,0,7153,72321,22,269,170,515,8.9,89.8,0.0,0.3,0.2,0.6
E09000003,BARNET,159516,159071,97.2,60.6,57.0,21.5,54.9,0.0,0.0,0.1,2.5,0.2,98.1,0.0,155032,96683,90854,34323,87621,2,15,195,4039,265,156464,0,64178,90854,2,13,180,3844,40.2,57.0,0.0,0.0,0.1,2.4
E08000016,BARNSLEY,117673,117274,97.9,69.6,65.7,22.5,22.5,0.1,0.2,0.4,1.8,0.3,99.0,0.0,115209,81887,77367,26532,26534,98,288,439,2065,320,116448,0,37842,77367,98,190,151,1626,32.2,65.7,0.1,0.2,0.1,1.4
E07000027,BARROW-IN-FURNESS,35566,35465,98.5,1.0,1.0,1.0,1.0,0.2,0.2,0.4,1.2,0.2,99.7,0.1,35039,353,353,353,353,55,81,132,426,60,35454,35,34686,353,55,26,51,294,97.5,1.0,0.2,0.1,0.1,0.8
E07000066,BASILDON,83610,83352,97.9,78.9,77.6,23.8,23.8,0.0,0.1,0.4,1.8,0.2,99.2,0.0,81822,65970,64840,19865,19865,14,124,310,1530,179,82954,0,16982,64840,14,110,186,1220,20.3,77.6,0.0,0.1,0.2,1.5
E07000084,BASINGSTOKE AND DEANE,81765,81565,95.6,58.6,56.8,25.8,56.6,0.2,0.6,1.2,4.2,0.6,98.3,0.0,78141,47896,46421,21121,46284,143,507,989,3424,516,80407,0,31720,46421,143,364,482,2435,38.8,56.8,0.2,0.4,0.6,3.0
E07000171,BASSETLAW,56940,56544,95.5,34.4,32.5,8.8,8.8,0.4,0.8,1.3,3.9,0.8,98.6,6.7,54351,19565,18511,4993,4994,229,452,734,2193,430,56160,3828,35840,18511,229,223,282,1459,62.9,32.5,0.4,0.4,0.5,2.6
E06000022,BATH AND NORTH EAST SOMERSET,88630,88394,93.4,65.9,59.3,30.2,30.2,0.2,0.3,0.7,6.4,0.3,95.5,0.0,82739,58426,52529,26722,26722,133,248,631,5655,281,84675,0,30210,52529,133,115,383,5024,34.1,59.3,0.2,0.1,0.4,5.7
E06000055,BEDFORD,81659,81479,97.0,75.5,72.3,12.9,12.9,0.2,0.5,0.9,2.8,0.2,98.9,0.0,79186,61664,59015,10522,10522,145,390,701,2293,192,80734,0,20171,59015,145,245,311,1592,24.7,72.3,0.2,0.3,0.4,1.9
N09000003,BELFAST,166868,165569,97.5,91.4,91.0,73.3,91.0,0.0,0.1,0.4,1.7,0.4,97.7,0.0,162760,152555,151911,122304,151912,40,170,712,2809,717,163110,0,10849,151911,40,130,542,2097,6.5,91.0,0.0,0.1,0.3,1.3
E09000004,BEXLEY,103256,103039,97.1,79.7,78.7,33.9,78.1,0.0,0.1,0.8,2.7,0.2,97.7,0.0,100261,82339,81246,35016,80683,4,113,806,2778,218,100843,0,19015,81246,4,109,693,1972,18.4,78.7,0.0,0.1,0.7,1.9
E08000025,BIRMINGHAM,474514,471205,95.6,90.1,89.2,37.0,88.6,0.0,0.2,0.7,3.7,0.3,95.7,0.0,453660,427564,423162,175502,420252,34,742,3381,17545,1379,453967,0,30498,423162,34,708,2639,14164,6.4,89.2,0.0,0.1,0.6,3.0
E07000129,BLABY,45282,45210,97.7,72.6,70.2,33.7,33.7,0.1,0.3,0.4,2.1,0.1,98.8,0.0,44258,32865,31788,15266,15266,33,124,177,952,57,44716,0,12470,31788,33,91,53,775,27.5,70.2,0.1,0.2,0.1,1.7
E06000008,BLACKBURN WITH DARWEN,67443,67157,97.3,67.8,67.3,10.2,10.2,0.0,0.2,0.5,2.3,0.3,98.7,22.0,65610,45698,45399,6884,6902,29,162,329,1547,189,66562,14865,20211,45399,29,133,167,1218,30.0,67.3,0.0,0.2,0.2,1.8
E06000009,BLACKPOOL,77763,77521,98.4,70.6,70.4,0.7,0.7,0.0,0.0,0.0,1.3,0.1,98.6,0.0,76548,54881,54741,554,554,3,12,36,973,100,76649,0,21807,54741,3,9,24,937,28.0,70.4,0.0,0.0,0.0,1.2
W06000019,BLAENAU GWENT,35273,35161,96.5,5.0,3.6,2.4,2.4,0.0,0.2,0.7,3.2,0.4,99.2,0.1,34027,1777,1257,853,853,15,86,248,1134,126,34990,18,32770,1257,15,71,162,886,92.9,3.6,0.0,0.2,0.5,2.5
E07000033,BOLSOVER,38855,38741,94.8,42.2,37.4,14.0,14.0,0.1,0.2,0.4,4.9,0.3,98.4,0.0,36836,16392,14518,5456,5456,22,65,157,1905,119,38245,0,22318,14518,22,43,92,1748,57.4,37.4,0.1,0.1,0.2,4.5
E08000001,BOLTON,133444,132921,98.2,86.5,84.4,8.1,83.0,0.0,0.1,0.3,1.5,0.3,98.9,0.0,130981,115454,112682,10845,110713,23,136,430,1940,337,132009,0,18299,112682,23,113,294,1510,13.7,84.4,0.0,0.1,0.2,1.1
E07000136,BOSTON,33344,32989,91.0,4.5,4.5,4.5,4.5,0.7,1.5,2.3,7.9,1.6,97.0,2.9,30352,1501,1500,1501,1501,218,515,770,2637,547,32358,966,28852,1500,218,297,255,1867,86.5,4.5,0.7,0.9,0.8,5.6
E06000058,"BOURNEMOUTH, CHRISTCHURCH AND POOLE",198122,196808,98.0,81.3,78.7,23.1,23.1,0.2,0.2,0.3,1.3,0.6,98.8,0.0,194168,161065,155963,45676,45678,336,376,638,2640,1090,195821,0,38205,155963,336,40,262,2002,19.3,78.7,0.2,0.0,0.1,1.0
E06000036,BRACKNELL FOREST,54367,54075,95.8,62.0,58.5,9.2,56.4,0.1,0.3,0.9,3.6,0.4,98.1,0.0,52099,33732,31800,5015,30682,71,165,493,1976,191,53314,0,20299,31800,71,94,328,1483,37.3,58.5,0.1,0.2,0.6,2.7
E08000032,BRADFORD,216836,216037,96.3,81.3,78.8,3.7,77.3,0.1,0.2,0.5,3.3,0.3,97.7,20.8,208911,176225,170891,8078,167518,170,535,1084,7126,557,211893,45207,38020,170891,170,365,549,6042,17.5,78.8,0.1,0.2,0.3,2.8
E07000067,BRAINTREE,70880,70521,93.2,12.9,12.9,12.9,12.9,0.5,1.4,2.3,6.3,1.4,96.6,0.0,66051,9156,9156,9120,9120,376,996,1651,4470,1005,68496,0,56895,9156,376,620,655,2819,80.3,12.9,0.5,0.9,0.9,4.0
E07000143,BRECKLAND,66313,66080,90.7,19.3,17.6,16.3,16.3,0.7,1.8,3.0,9.0,1.7,97.6,0.0,60135,12769,11657,10793,10793,463,1169,1982,5945,1120,64745,0,48478,11657,463,706,813,3963,73.1,17.6,0.7,1.1,1.2,6.0
E09000005,BRENT,135629,134446,96.7,74.2,71.8,29.3,70.2,0.0,0.1,0.4,2.4,0.8,96.8,0.0,131175,100652,97358,39743,95269,2,81,571,3271,1063,131287,0,33817,97358,2,79,490,2700,24.9,71.8,0.0,0.1,0.4,2.0
E07000068,BRENTWOOD,35569,35370,94.7,16.3,16.3,16.2,16.2,0.1,0.3,0.7,4.7,0.4,98.5,0.0,33690,5781,5780,5779,5779,31,111,256,1680,151,35018,0,27910,5780,31,80,145,1424,78.5,16.3,0.1,0.2,0.4,4.0
W06000013,BRIDGEND,67375,67184,97.0,43.4,34.5,28.8,28.8,0.1,0.1,0.6,2.7,0.2,98.8,36.5,65359,29222,23252,19372,19395,34,92,417,1825,119,66546,24621,42107,23252,34,58,325,1408,62.5,34.5,0.1,0.1,0.5,2.1
E06000043,BRIGHTON AND HOVE,141675,140796,97.3,84.8,81.2,5.9,5.9,0.0,0.2,0.7,2.1,0.2,97.5,0.0,137816,120133,115056,8399,8399,7,213,998,2980,332,138105,0,22760,115056,7,206,785,1982,16.1,81.2,0.0,0.1,0.6,1.4
E06000023,"BRISTOL, CITY OF",210136,209222,95.9,90.0,88.9,49.0,49.0,0.0,0.1,0.5,3.7,0.3,96.0,0.0,201432,189187,186821,102971,102985,14,151,1042,7790,659,201727,0,14611,186821,14,137,891,6748,7.0,88.9,0.0,0.1,0.4,3.2
E07000144,BROADLAND,61334,61091,94.1,43.6,40.1,7.6,7.6,0.3,0.8,1.7,5.5,1.1,98.5,0.0,57736,26745,24589,4676,4683,172,505,1014,3355,690,60384,0,33147,24589,172,333,509,2341,54.0,40.1,0.3,0.5,0.8,3.8
E09000006,BROMLEY,146499,146307,97.6,86.6,86.3,9.6,73.9,0.0,0.3,0.5,2.3,0.1,98.5,0.0,142941,126883,126426,14092,108297,56,389,701,3366,158,144272,0,16515,126426,56,333,312,2665,11.3,86.3,0.0,0.2,0.2,1.8
E07000234,BROMSGROVE,44975,44780,96.4,64.5,64.4,44.2,64.4,0.1,0.4,0.7,3.2,0.3,99.2,0.1,43357,28994,28953,19882,28958,36,173,328,1423,147,44599,53,14404,28953,36,137,155,1095,32.0,64.4,0.1,0.3,0.3,2.4
E07000095,BROXBOURNE,43051,43020,98.7,86.6,82.9,3.8,3.8,0.1,0.1,0.2,1.3,0.1,99.3,0.0,42477,37290,35703,1629,1629,27,40,107,543,28,42762,0,6774,35703,27,13,67,436,15.7,82.9,0.1,0.0,0.2,1.0
E07000172,BROXTOWE,52183,52072,98.8,91.5,90.4,3.6,3.6,0.0,0.1,0.2,1.0,0.2,99.4,0.0,51556,47746,47185,1892,1892,16,58,100,516,106,51881,0,4371,47185,16,42,42,416,8.4,90.4,0.0,0.1,0.1,0.8
E06000060,BUCKINGHAMSHIRE,240017,238964,93.8,47.9,42.0,11.0,18.0,0.2,0.9,1.7,5.7,0.5,97.9,0.0,225232,114916,100881,26497,43152,512,2188,4174,13732,1194,234936,0,124351,100881,512,1676,1986,9558,51.8,42.0,0.2,0.7,0.8,4.0
E07000117,BURNLEY,45267,45117,97.9,79.0,79.0,1.5,79.0,0.1,0.1,0.3,1.7,0.3,99.3,4.5,44339,35759,35751,677,35750,32,59,131,778,124,44931,2030,8588,35751,32,27,72,647,19.0,79.0,0.1,0.1,0.2,1.4
E08000002,BURY,88935,88068,97.2,66.3,60.3,36.3,56.0,0.0,0.1,0.2,1.8,0.7,98.9,0.0,86432,58969,53652,32262,49848,14,85,161,1636,596,87948,0,32780,53652,14,71,76,1475,36.9,60.3,0.0,0.1,0.1,1.7
W06000018,CAERPHILLY,83223,82999,97.9,28.7,24.4,21.5,21.5,0.1,0.1,0.3,1.8,0.1,99.5,47.1,81514,23882,20326,17909,17910,44,116,219,1485,109,82819,39176,61188,20326,44,72,103,1266,73.5,24.4,0.1,0.1,0.1,1.5
E08000033,CALDERDALE,103835,103347,94.8,49.8,49.3,11.3,11.3,0.1,0.4,0.8,4.8,0.3,98.3,0.0,98409,51688,51179,11713,11714,113,393,800,4938,264,102084,3,47230,51179,113,280,407,4138,45.5,49.3,0.1,0.3,0.4,4.0
E07000008,CAMBRIDGE,59880,59741,98.2,90.4,87.8,24.1,24.1,0.0,0.0,0.2,1.5,0.2,98.3,0.4,58818,54117,52574,14461,14461,1,18,113,923,119,58856,269,6244,52574,1,17,95,810,10.4,87.8,0.0,0.0,0.2,1.4
E09000007,CAMDEN,121444,120321,95.9,88.8,87.0,31.0,87.1,0.0,0.0,0.0,3.1,0.6,95.9,0.0,116509,107869,105659,37687,105731,0,0,43,3812,727,116514,0,10850,105659,0,0,43,3769,8.9,87.0,0.0,0.0,0.0,3.1
E07000192,CANNOCK CHASE,47682,47493,97.7,25.9,25.8,4.4,25.6,0.0,0.1,0.2,1.9,0.2,99.3,0.0,46568,12330,12283,2113,12217,18,41,108,925,113,47347,0,34285,12283,18,23,67,817,71.9,25.8,0.0,0.0,0.1,1.7
E07000106,CANTERBURY,73504,73218,93.9,4.7,4.7,4.7,4.7,0.3,0.6,1.2,5.7,0.5,99.1,0.0,69027,3451,3451,3451,3451,194,472,885,4191,348,72869,0,65576,3451,194,278,413,3306,89.2,4.7,0.3,0.4,0.6,4.5
W06000015,CARDIFF,165947,165280,97.5,85.9,83.2,45.2,81.6,0.0,0.2,0.6,2.1,0.2,98.0,62.4,161760,142475,138141,74999,135359,32,336,958,3520,279,162550,103622,23619,138141,32,304,622,2562,14.2,83.2,0.0,0.2,0.4,1.5
E07000028,CARLISLE,57264,56943,93.5,54.2,47.9,5.6,5.6,0.8,1.7,3.2,5.9,1.5,97.1,0.1,53542,31048,27411,3231,3231,459,950,1848,3401,846,55582,36,26131,27411,459,491,898,1553,45.6,47.9,0.8,0.9,1.6,2.7
W06000010,CARMARTHENSHIRE,93138,92260,86.3,22.0,22.0,22.0,22.0,1.9,4.2,6.7,12.7,2.6,93.2,12.6,80420,20531,20531,20527,20527,1792,3951,6202,11840,2417,86763,11741,59889,20531,1792,2159,2251,5638,64.3,22.0,1.9,2.3,2.4,6.1
E07000069,CASTLE POINT,41063,40747,98.3,43.8,43.8,2.5,2.5,0.0,0.1,0.2,0.9,0.6,98.7,0.0,40365,17996,17979,1009,1009,12,48,73,382,258,40540,0,22386,17979,12,36,25,309,54.5,43.8,0.0,0.1,0.1,0.8
N09000004,CAUSEWAY COAST AND GLENS,66090,64558,85.4,47.9,47.8,47.8,47.8,2.4,4.4,6.0,12.3,3.9,97.0,0.0,56444,31626,31615,31620,31624,1558,2918,3959,8114,2573,64124,0,24829,31615,1558,1360,1041,4155,37.6,47.8,2.4,2.1,1.6,6.3
E06000056,CENTRAL BEDFORDSHIRE,126755,126547,97.0,69.7,66.8,15.6,15.6,0.1,0.6,1.0,2.9,0.3,99.0,0.0,122919,88324,84616,19828,19828,135,780,1296,3628,358,125454,0,38303,84616,135,645,516,2332,30.2,66.8,0.1,0.5,0.4,1.8
W06000008,CEREDIGION,37603,37299,80.6,20.7,20.7,20.7,20.7,3.0,7.0,11.5,18.6,4.6,88.7,3.4,30291,7779,7779,7779,7779,1122,2617,4334,7008,1729,33348,1263,22512,7779,1122,1495,1717,2674,59.9,20.7,3.0,4.0,4.6,7.1
E07000130,CHARNWOOD,79546,79356,97.3,72.8,69.5,10.3,10.3,0.1,0.2,0.6,2.4,0.2,98.4,0.0,77411,57870,55299,8167,8167,92,184,449,1945,141,78311,0,22112,55299,92,92,265,1496,27.8,69.5,0.1,0.1,0.3,1.9
E07000070,CHELMSFORD,82172,81949,94.9,61.4,58.0,36.0,36.0,0.1,0.4,0.9,4.8,0.3,98.1,0.0,77991,50421,47653,29566,29566,59,354,716,3958,241,80632,0,30338,47653,59,295,362,3242,36.9,58.0,0.1,0.4,0.4,3.9
E07000078,CHELTENHAM,60183,59958,98.6,76.2,69.0,5.8,5.8,0.0,0.1,0.3,1.0,0.4,99.1,0.0,59365,45832,41548,3517,3517,19,49,158,593,214,59618,0,17817,41548,19,30,109,435,29.6,69.0,0.0,0.0,0.2,0.7
E07000177,CHERWELL,71294,70919,96.1,47.8,38.5,10.8,10.8,0.3,0.5,1.1,3.3,0.4,98.3,0.0,68545,34066,27429,7684,7684,180,328,751,2374,296,70082,0,41116,27429,180,148,423,1623,57.7,38.5,0.3,0.2,0.6,2.3
E06000049,CHESHIRE EAST,189880,189163,93.5,47.4,40.7,12.3,20.2,0.3,0.8,1.6,6.1,0.5,98.2,1.5,177570,89931,77303,23282,38381,576,1555,3064,11593,860,186481,2794,100267,77303,576,979,1509,8529,52.8,40.7,0.3,0.5,0.8,4.5
E06000050,CHESHIRE WEST AND CHESTER,169670,169141,94.9,48.4,41.4,23.7,23.7,0.2,0.6,1.3,4.8,0.3,98.6,0.5,160938,82098,70328,40131,40131,286,1074,2127,8203,540,167341,774,90610,70328,286,788,1053,6076,53.4,41.4,0.2,0.5,0.6,3.6
E07000034,CHESTERFIELD,53359,53216,97.1,53.5,52.8,22.3,22.3,0.0,0.0,0.2,2.6,0.2,99.0,0.0,51834,28567,28147,11913,11913,0,13,109,1382,85,52836,0,23687,28147,0,13,96,1273,44.4,52.8,0.0,0.0,0.2,2.4
E07000225,CHICHESTER,62408,61654,90.3,24.9,22.8,21.5,21.5,0.4,1.0,2.2,8.5,2.0,97.9,0.0,56345,15569,14233,13428,13428,223,642,1369,5309,1226,61114,0,42112,14233,223,419,727,3940,67.5,22.8,0.4,0.7,1.2,6.3
E07000118,CHORLEY,54761,54504,95.4,59.7,55.9,12.7,12.7,0.1,0.2,0.8,4.1,0.5,98.8,5.2,52242,32680,30591,6953,6954,29,133,419,2262,263,54123,2862,21651,30591,29,104,286,1843,39.5,55.9,0.1,0.2,0.5,3.4
S12000036,CITY OF EDINBURGH,265374,265226,97.5,86.0,84.0,40.6,82.7,0.0,0.2,0.4,2.4,0.1,97.9,0.0,258791,228236,223034,107728,219338,112,472,1052,6435,157,259933,0,35757,223034,112,360,580,5383,13.5,84.0,0.0,0.1,0.2,2.0
E09000001,CITY OF LONDON,10865,10757,56.0,47.1,46.4,45.8,46.4,0.0,0.0,0.0,43.0,0.3,56.0,0.0,6089,5112,5042,4975,5037,0,0,0,4668,29,6089,0,1047,5042,0,0,0,4668,9.6,46.4,0.0,0.0,0.0,43.0
S12000005,CLACKMANNANSHIRE,25942,25753,94.4,22.1,10.6,5.7,5.7,0.1,0.2,0.4,4.9,0.8,99.1,0.0,24494,5731,2758,1482,1482,28,48,92,1259,215,25699,0,21736,2758,28,20,44,1167,83.8,10.6,0.1,0.1,0.2,4.5
E07000071,COLCHESTER,87912,87123,94.5,56.3,56.1,11.5,11.5,0.1,0.9,1.8,4.6,1.3,96.6,0.0,83049,49514,49342,10071,10071,131,818,1556,4074,1180,84889,0,33707,49342,131,687,738,2518,38.3,56.1,0.1,0.8,0.8,2.9
W06000003,CONWY,59336,59224,93.5,8.4,8.4,8.4,8.4,0.8,1.9,3.2,6.3,1.1,97.3,58.5,55473,4961,4961,4961,4961,464,1134,1898,3751,672,57716,34691,50512,4961,464,670,764,1853,85.1,8.4,0.8,1.1,1.3,3.1
E07000029,COPELAND,35714,35571,94.8,1.6,1.6,1.6,1.6,0.3,0.7,1.4,4.8,1.0,99.0,0.0,33866,588,588,588,588,109,260,499,1705,364,35340,0,33278,588,109,151,239,1206,93.2,1.6,0.3,0.4,0.7,3.4
E07000150,CORBY,32657,32531,98.6,82.7,82.7,27.0,27.0,0.1,0.2,0.3,1.1,0.4,99.1,0.0,32186,27018,27012,8833,8833,19,65,88,345,143,32348,0,5174,27012,19,46,23,257,15.8,82.7,0.1,0.1,0.1,0.8
E06000052,CORNWALL,300356,297692,87.1,35.5,34.1,31.3,31.3,0.3,1.1,2.4,12.0,1.2,92.3,3.0,261690,106574,102558,93946,93946,954,3229,7330,36002,3641,277179,8999,159132,102558,954,2275,4101,28672,53.0,34.1,0.3,0.8,1.4,9.5
E07000079,COTSWOLD,47280,47008,93.4,39.6,39.4,39.3,39.3,0.2,0.9,1.8,6.0,1.1,95.3,0.1,44164,18715,18632,18572,18572,83,413,864,2844,500,45049,68,25532,18632,83,330,451,1980,54.0,39.4,0.2,0.7,1.0,4.2
E06000047,COUNTY DURHAM,259981,259020,93.9,26.4,22.3,18.3,18.3,0.3,0.8,1.5,5.8,0.6,98.5,0.2,244067,68711,57853,47624,47624,895,2185,3861,14953,1485,256113,635,186214,57853,895,1290,1676,11092,71.6,22.3,0.3,0.5,0.6,4.3
E08000026,COVENTRY,148637,148073,97.8,91.4,91.2,75.5,91.3,0.0,0.3,0.6,1.8,0.3,98.0,0.0,145391,135829,135597,112212,135650,3,440,829,2682,501,145605,0,9794,135597,3,437,389,1853,6.6,91.2,0.0,0.3,0.3,1.2
E07000163,CRAVEN,30158,29958,92.0,22.5,17.3,12.1,12.2,1.1,2.0,3.1,7.3,1.0,97.1,34.1,27756,6800,5207,3661,3674,317,595,945,2202,292,29297,10286,22549,5207,317,278,350,1257,74.8,17.3,1.1,0.9,1.2,4.2
E07000226,CRAWLEY,49295,49115,98.5,82.8,80.7,3.2,3.2,0.0,0.1,0.3,1.2,0.4,99.0,0.0,48541,40797,39773,1558,1558,18,60,156,574,179,48789,0,8768,39773,18,42,96,418,17.8,80.7,0.0,0.1,0.2,0.8
E09000008,CROYDON,168358,167924,96.0,84.7,83.6,20.8,83.5,0.0,0.1,0.3,3.7,0.2,96.6,0.0,161642,142523,140696,35060,140586,1,89,521,6282,286,162630,0,20946,140696,1,88,432,5761,12.4,83.6,0.0,0.1,0.3,3.4
E07000096,DACORUM,68834,68639,96.5,76.6,73.5,4.7,4.7,0.2,0.4,0.8,3.2,0.3,98.8,0.0,66443,52705,50560,3239,3240,106,306,536,2196,190,68022,0,15883,50560,106,200,230,1660,23.1,73.5,0.2,0.3,0.3,2.4
E06000005,DARLINGTON,54559,54442,93.9,82.1,81.3,2.5,2.5,0.8,2.2,3.6,5.9,0.4,95.5,22.5,51238,44771,44367,1347,1347,431,1207,1947,3204,210,52086,12263,6871,44367,431,776,740,1257,12.6,81.3,0.8,1.4,1.4,2.3
E07000107,DARTFORD,49540,49474,95.9,55.0,51.2,15.5,48.3,0.3,0.8,1.4,4.0,0.1,98.0,0.0,47507,27240,25353,7673,23927,138,385,703,1967,55,48531,0,22154,25353,138,247,318,1264,44.7,51.2,0.3,0.5,0.6,2.6
E07000151,DAVENTRY,38372,38268,95.1,39.4,33.5,28.2,28.2,0.3,0.9,1.9,4.7,0.3,97.5,0.0,36482,15112,12859,10813,10813,121,348,728,1786,133,37398,0,23623,12859,121,227,380,1058,61.6,33.5,0.3,0.6,1.0,2.8
W06000004,DENBIGHSHIRE,49705,49346,89.8,9.1,9.1,9.1,9.1,0.8,1.9,4.2,9.5,1.3,94.4,30.7,44638,4518,4518,4518,4518,395,958,2064,4708,649,46897,15273,40120,4518,395,563,1106,2644,80.7,9.1,0.8,1.1,2.2,5.3
E06000015,DERBY,119372,118689,98.7,89.6,88.8,22.8,22.8,0.0,0.0,0.1,0.7,0.5,99.0,0.0,117861,106960,105984,27217,27256,11,45,130,828,619,118161,0,11877,105984,11,34,85,698,9.9,88.8,0.0,0.0,0.1,0.6
E07000035,DERBYSHIRE DALES,37443,37263,89.3,8.4,8.4,8.4,8.4,0.6,1.8,4.0,10.2,1.6,96.5,0.0,33448,3135,3135,3135,3135,209,689,1485,3815,598,36140,0,30313,3135,209,480,796,2330,81.0,8.4,0.6,1.3,2.1,6.2
N09000005,DERRY CITY AND STRABANE,62612,62326,90.6,69.9,69.9,54.1,69.9,2.3,3.6,4.8,9.0,2.7,98.5,0.0,56698,43766,43751,33850,43762,1411,2225,2993,5628,1701,61695,0,12947,43751,1411,814,768,2635,20.7,69.9,2.3,1.3,1.2,4.2
E08000017,DONCASTER,146794,146269,97.5,61.4,61.0,36.5,36.5,0.1,0.3,0.6,2.1,0.2,98.7,14.6,143119,90064,89552,53588,53589,106,425,890,3150,363,144951,21405,53567,89552,106,319,465,2260,36.5,61.0,0.1,0.2,0.3,1.5
E06000059,DORSET,190127,189058,92.8,12.8,12.2,9.7,9.7,0.2,0.7,1.4,6.7,0.8,98.1,7.5,176414,24327,23197,18391,18391,371,1327,2657,12644,1483,186592,14341,153217,23197,371,956,1330,9987,80.6,12.2,0.2,0.5,0.7,5.3
E07000108,DOVER,55669,55480,92.8,34.5,34.5,8.3,8.3,0.6,1.0,2.0,6.9,0.5,98.2,0.0,51654,19225,19221,4600,4600,319,570,1117,3826,264,54673,0,32433,19221,319,251,547,2709,58.3,34.5,0.6,0.5,1.0,4.9
E08000027,DUDLEY,147504,147140,99.0,91.0,89.7,2.8,82.8,0.0,0.0,0.1,0.8,0.2,99.3,4.4,145959,134191,132336,4072,122118,3,15,76,1181,294,146526,6486,13623,132336,3,12,61,1105,9.2,89.7,0.0,0.0,0.0,0.7
S12000006,DUMFRIES AND GALLOWAY,82564,81163,84.6,6.1,6.1,6.1,6.1,1.7,4.0,6.9,13.7,3.7,95.3,0.0,69851,5066,5065,5065,5065,1439,3280,5732,11312,3093,78687,0,64786,5065,1439,1841,2452,5580,78.5,6.1,1.7,2.2,3.0,6.8
S12000042,DUNDEE CITY,79432,79372,98.5,87.4,84.9,1.5,1.5,0.0,0.0,0.2,1.5,0.0,99.1,0.0,78205,69433,67472,1218,1218,5,22,182,1167,39,78687,0,10733,67472,5,17,160,985,13.5,84.9,0.0,0.0,0.2,1.2
E09000009,EALING,148646,147854,98.0,75.4,73.6,16.0,73.0,0.0,0.0,0.4,1.5,0.2,98.0,0.0,145620,112118,109460,23723,108471,1,53,651,2234,227,145663,0,36160,109460,1,52,598,1583,24.3,73.6,0.0,0.0,0.4,1.1
S12000008,EAST AYRSHIRE,60540,60319,95.5,45.2,44.6,36.8,36.8,0.6,1.2,2.0,4.2,0.5,98.4,0.0,57794,27368,26997,22269,22269,377,738,1209,2525,331,59596,0,30797,26997,377,361,471,1316,50.9,44.6,0.6,0.6,0.8,2.2
E07000009,EAST CAMBRIDGESHIRE,39910,39522,94.8,45.6,39.3,23.3,23.3,0.4,1.0,1.6,4.2,1.1,98.4,30.2,37835,18198,15685,9300,9300,179,391,658,1687,441,39282,12059,22150,15685,179,212,267,1029,55.5,39.3,0.4,0.5,0.7,2.6
E07000040,EAST DEVON,74761,74480,89.0,32.8,31.8,31.0,31.0,0.5,2.0,4.0,10.6,0.9,96.1,14.6,66564,24522,23745,23141,23141,387,1518,3005,7916,708,71854,10916,42819,23745,387,1131,1487,4911,57.3,31.8,0.5,1.5,2.0,6.6
S12000045,EAST DUNBARTONSHIRE,50429,50015,96.1,78.1,77.0,18.8,76.3,0.1,0.2,0.6,3.1,0.8,98.1,0.0,48449,39368,38829,9482,38467,28,114,289,1566,413,49467,0,9620,38829,28,86,175,1277,19.1,77.0,0.1,0.2,0.3,2.5
E07000085,EAST HAMPSHIRE,57662,57210,92.3,43.0,39.7,13.4,13.4,0.2,0.6,1.3,6.9,1.0,97.1,0.0,53245,24811,22914,7707,7707,102,346,764,3965,601,55974,0,30331,22914,102,244,418,3201,52.6,39.7,0.2,0.4,0.7,5.6
E07000242,EAST HERTFORDSHIRE,66725,66601,95.0,68.8,65.6,10.4,10.4,0.2,0.5,0.9,4.8,0.4,97.5,0.0,63417,45915,43798,6914,6914,125,333,620,3184,252,65037,0,19619,43798,125,208,287,2564,29.4,65.6,0.2,0.3,0.4,3.8
E07000137,EAST LINDSEY,72641,72137,87.7,19.2,15.3,4.0,4.0,0.9,2.7,4.9,11.6,2.5,97.1,10.9,63699,13927,11147,2916,2917,647,1948,3581,8438,1793,70507,7948,52552,11147,647,1301,1633,4857,72.3,15.3,0.9,1.8,2.2,6.7
S12000010,EAST LOTHIAN,48923,48712,92.7,30.5,29.6,30.5,30.5,0.4,1.4,2.4,6.8,0.6,97.4,41.4,45369,14918,14500,14914,14918,198,697,1192,3343,283,47652,20260,30869,14500,198,499,495,2151,63.1,29.6,0.4,1.0,1.0,4.4
E07000152,EAST NORTHAMPTONSHIRE,43285,43133,97.8,58.8,58.5,14.1,14.1,0.0,0.3,0.4,1.8,0.5,98.7,0.0,42334,25430,25323,6092,6092,20,119,190,799,212,42736,1,17011,25323,20,99,71,609,39.3,58.5,0.0,0.2,0.2,1.4
S12000011,EAST RENFREWSHIRE,41146,41103,95.9,70.6,70.0,7.5,69.9,0.1,0.2,0.6,4.0,0.2,98.8,0.0,39472,29042,28788,3075,28760,37,98,239,1631,70,40650,0,10684,28788,37,61,141,1392,26.0,70.0,0.1,0.1,0.3,3.4
E06000011,EAST RIDING OF YORKSHIRE,166380,165112,95.5,57.7,56.4,55.5,55.5,0.5,1.0,1.5,3.7,0.3,98.4,33.4,158890,95975,93798,92318,92318,765,1622,2494,6222,505,163677,55530,65092,93798,765,857,872,3728,39.1,56.4,0.5,0.5,0.5,2.2
E07000193,EAST STAFFORDSHIRE,55796,55455,94.4,39.0,34.9,31.2,31.2,0.3,0.8,1.5,5.0,0.7,98.3,0.0,52669,21755,19485,17430,17430,160,444,844,2786,391,54832,0,33184,19485,160,284,400,1942,59.5,34.9,0.3,0.5,0.7,3.5
E07000244,EAST SUFFOLK,127020,126055,94.0,20.6,20.6,14.2,14.2,0.2,0.7,1.3,5.3,0.7,97.9,0.0,119350,26204,26145,18035,18035,220,861,1667,6705,884,124412,0,93205,26145,220,641,806,5038,73.4,20.6,0.2,0.5,0.6,4.0
E07000061,EASTBOURNE,50844,50737,98.6,3.0,3.0,3.0,3.0,0.0,0.0,0.1,1.2,0.1,99.3,0.0,50152,1515,1515,1515,1515,1,13,70,585,40,50467,0,48637,1515,1,12,57,515,95.7,3.0,0.0,0.0,0.1,1.0
E07000086,EASTLEIGH,60743,60579,97.4,75.8,73.2,15.5,26.3,0.0,0.0,0.1,2.4,0.2,98.9,0.0,59149,46051,44456,9432,15984,0,4,89,1430,134,60049,0,14693,44456,0,4,85,1341,24.2,73.2,0.0,0.0,0.1,2.2
E07000030,EDEN,29931,29516,80.9,5.3,5.3,5.3,5.3,3.8,7.5,10.2,17.7,2.5,94.3,4.7,24206,1575,1575,1575,1575,1138,2250,3061,5310,751,28226,1417,22631,1575,1138,1112,811,2249,75.6,5.3,3.8,3.7,2.7,7.5
E07000207,ELMBRIDGE,60956,60776,98.1,73.2,70.6,4.6,4.6,0.1,0.1,0.1,1.6,0.2,99.3,0.0,59819,44595,43024,2803,2811,31,44,73,957,147,60545,0,16795,43024,31,13,29,884,27.6,70.6,0.1,0.0,0.0,1.5
E09000010,ENFIELD,133222,132091,96.8,87.4,86.3,3.5,85.6,0.0,0.1,0.7,2.3,0.8,97.2,0.0,128985,116437,114919,4688,114013,32,143,881,3106,1075,129479,0,14066,114919,32,111,738,2225,10.6,86.3,0.0,0.1,0.6,1.7
E07000072,EPPING FOREST,61241,61009,94.4,78.5,76.8,14.5,74.4,0.2,0.6,1.4,5.2,0.5,96.8,0.0,57822,48057,47018,8881,45545,119,389,844,3187,292,59256,0,10804,47018,119,270,455,2343,17.6,76.8,0.2,0.4,0.7,3.8
E07000208,EPSOM AND EWELL,33273,33233,99.5,88.7,88.6,67.0,67.1,0.0,0.1,0.2,0.4,0.1,99.6,0.0,33095,29520,29464,22283,22313,0,49,53,138,45,33141,0,3631,29464,0,49,4,85,10.9,88.6,0.0,0.1,0.0,0.3
E07000036,EREWASH,55821,55651,98.0,76.8,75.2,12.2,12.2,0.2,0.3,0.4,1.7,0.2,99.4,0.0,54729,42849,41986,6809,6809,133,181,236,922,125,55460,0,12743,41986,133,48,55,686,22.8,75.2,0.2,0.1,0.1,1.2
E07000041,EXETER,58334,57990,95.8,87.0,86.7,62.3,62.3,0.1,0.2,1.4,3.6,0.3,96.4,33.7,55895,50753,50583,36314,36314,32,120,824,2095,199,56215,19656,5312,50583,32,88,704,1271,9.1,86.7,0.1,0.2,1.2,2.2
S12000014,FALKIRK,73925,73877,96.9,85.2,85.0,9.8,84.9,0.1,0.4,1.0,3.0,0.2,98.7,0.0,71645,63002,62852,7276,62780,66,321,718,2232,176,72949,0,8793,62852,66,255,397,1514,11.9,85.0,0.1,0.3,0.5,2.0
E07000087,FAREHAM,52642,52575,98.3,86.2,83.7,5.3,5.3,0.1,0.1,0.4,1.6,0.1,99.4,0.0,51744,45361,44082,2772,2816,47,78,220,831,50,52322,0,7662,44082,47,31,142,611,14.6,83.7,0.1,0.1,0.3,1.2
E07000010,FENLAND,48105,47933,94.5,58.9,58.7,29.8,29.8,0.4,1.0,1.6,5.1,0.6,98.4,5.8,45477,28353,28227,14337,14337,170,469,750,2456,289,47356,2784,17250,28227,170,299,281,1706,35.9,58.7,0.4,0.6,0.6,3.5
N09000006,FERMANAGH AND OMAGH,50037,49150,69.2,26.4,26.4,26.4,26.4,8.3,13.7,18.4,29.0,5.0,96.9,39.9,34635,13201,13201,13201,13201,4169,6839,9182,14515,2525,48500,19964,21434,13201,4169,2670,2343,5333,42.8,26.4,8.3,5.3,4.7,10.7
S12000047,FIFE,191238,190156,95.3,53.5,52.8,24.7,24.7,0.3,0.8,1.4,4.1,0.6,98.5,0.0,182288,102257,100942,47154,47154,538,1489,2772,7868,1117,188377,0,81346,100942,538,951,1283,5096,42.5,52.8,0.3,0.5,0.7,2.7
W06000005,FLINTSHIRE,74090,73805,94.1,35.6,28.4,24.2,24.2,0.4,1.2,2.6,5.6,0.6,97.2,39.6,69683,26363,21077,17941,17941,285,869,1902,4122,432,72028,29347,48606,21077,285,584,1033,2220,65.6,28.4,0.4,0.8,1.4,3.0
E07000112,FOLKESTONE AND HYTHE,54375,54188,92.9,41.4,41.2,5.5,5.5,0.5,1.2,2.3,6.7,0.5,97.6,0.0,50529,22505,22404,3007,3007,262,647,1270,3659,252,53058,0,28125,22404,262,385,623,2389,51.7,41.2,0.5,0.7,1.1,4.4
E07000080,FOREST OF DEAN,41587,41331,80.7,23.5,20.9,19.3,19.3,0.6,3.0,7.3,18.7,2.3,88.7,1.7,33542,9764,8706,8021,8021,253,1263,3018,7789,952,36869,702,24836,8706,253,1010,1755,4771,59.7,20.9,0.6,2.4,4.2,11.5
E07000119,FYLDE,36584,36322,93.9,44.6,33.4,5.4,5.4,0.1,0.4,0.9,5.4,0.7,97.9,0.0,34335,16308,12207,1968,1990,30,133,335,1987,257,35823,7,22128,12207,30,103,202,1652,60.5,33.4,0.1,0.3,0.6,4.5
E08000037,GATESHEAD,100972,100502,95.5,71.5,69.9,5.4,5.4,0.1,0.3,1.1,4.0,0.4,97.2,0.0,96469,72204,70606,5433,5433,56,299,1130,4033,414,98129,1,25863,70606,56,243,831,2903,25.6,69.9,0.1,0.2,0.8,2.9
E07000173,GEDLING,55253,55147,98.7,87.3,86.4,37.0,37.0,0.1,0.2,0.3,1.2,0.2,99.6,0.0,54511,48261,47741,20464,20464,35,124,155,636,98,55037,0,6770,47741,35,89,31,481,12.3,86.4,0.1,0.2,0.1,0.9
S12000049,GLASGOW CITY,336090,334491,97.0,71.6,65.5,18.6,61.3,0.0,0.0,0.2,2.6,0.2,97.3,0.0,325855,240615,220306,62590,206113,47,167,800,8636,643,327054,0,105549,220306,47,120,633,7836,31.4,65.5,0.0,0.0,0.2,2.3
E07000081,GLOUCESTER,60055,59981,98.7,87.3,86.5,9.8,9.8,0.0,0.2,0.6,1.2,0.1,99.1,0.0,59274,52441,51927,5893,5893,1,148,345,707,69,59488,0,7347,51927,1,147,197,362,12.2,86.5,0.0,0.2,0.3,0.6
E07000088,GOSPORT,38839,38814,99.1,85.7,85.7,4.5,4.5,0.0,0.0,0.1,0.8,0.1,99.6,0.0,38505,33288,33272,1731,1731,2,10,40,309,21,38689,0,5233,33272,2,8,30,269,13.5,85.7,0.0,0.0,0.1,0.7
E07000109,GRAVESHAM,45181,44984,96.0,70.6,64.5,6.9,6.9,0.1,0.3,0.6,3.5,0.4,98.5,0.0,43393,31919,29133,3115,3115,31,139,254,1591,184,44494,0,14260,29133,31,108,115,1337,31.6,64.5,0.1,0.2,0.3,3.0
E07000145,GREAT YARMOUTH,49271,49036,97.1,51.2,51.2,4.5,4.5,0.0,0.2,0.4,2.4,0.5,99.2,0.0,47833,25249,25238,2198,2199,12,78,194,1203,229,48867,0,22595,25238,12,66,116,1009,45.9,51.2,0.0,0.1,0.2,2.0
E09000011,GREENWICH,125439,124947,98.0,80.9,77.8,21.6,76.1,0.0,0.1,0.5,1.6,0.2,98.2,0.0,122974,101467,97619,27099,95520,1,157,571,1973,288,123177,0,25355,97619,1,156,414,1402,20.2,77.8,0.0,0.1,0.3,1.1
E07000209,GUILDFORD,58487,58365,96.1,67.9,64.6,2.7,2.7,0.0,0.2,0.7,3.7,0.3,99.0,0.0,56212,39689,37780,1576,1577,26,134,419,2153,189,57878,0,18432,37780,26,108,285,1734,31.5,64.6,0.0,0.2,0.5,3.0
W06000002,GWYNEDD,67919,67384,86.9,18.3,16.7,15.7,15.7,1.3,3.5,6.0,12.3,2.3,92.8,17.7,59052,12463,11336,10660,10660,902,2348,4100,8332,1549,63044,12015,47716,11336,902,1446,1752,4232,70.3,16.7,1.3,2.1,2.6,6.2
E09000012,HACKNEY,126044,125126,96.5,75.8,71.1,21.1,68.3,0.0,0.0,0.2,2.7,0.5,96.6,0.0,121683,95565,89639,26566,86073,0,0,256,3443,597,121737,0,32044,89639,0,0,256,3187,25.4,71.1,0.0,0.0,0.2,2.5
E06000006,HALTON,62372,61751,96.9,64.1,63.2,3.8,4.5,0.0,0.1,0.5,2.1,0.9,98.4,0.0,60437,39991,39441,2354,2806,18,85,288,1314,572,61365,0,20996,39441,18,67,203,1026,33.7,63.2,0.0,0.1,0.3,1.6
E07000164,HAMBLETON,44730,44485,89.0,7.7,6.9,6.6,6.6,1.5,3.4,5.4,10.5,1.2,97.5,31.6,39795,3422,3086,2946,2946,651,1526,2409,4690,537,43591,14130,36709,3086,651,875,883,2281,82.1,6.9,1.5,2.0,2.0,5.1
E09000013,HAMMERSMITH AND FULHAM,92597,91790,93.4,69.0,56.6,22.4,46.6,0.0,0.1,0.3,5.7,0.4,93.4,0.0,86502,63892,52445,20764,43158,0,74,255,5288,352,86488,0,34057,52445,0,74,181,5033,36.8,56.6,0.0,0.1,0.2,5.4
E07000131,HARBOROUGH,42903,42754,94.8,40.1,33.8,14.8,14.8,0.3,0.7,1.5,4.9,0.6,98.3,0.0,40663,17213,14521,6342,6342,137,312,632,2091,244,42163,0,26142,14521,137,175,320,1459,60.9,33.8,0.3,0.4,0.7,3.4
E09000014,HARINGEY,109528,109358,98.3,85.1,83.8,4.3,82.5,0.0,0.0,0.3,1.5,0.1,98.4,0.0,107706,93224,91781,4686,90344,1,17,298,1652,96,107786,0,15925,91781,1,16,281,1354,14.5,83.8,0.0,0.0,0.3,1.2
E07000073,HARLOW,41508,41256,96.1,90.1,88.2,5.7,5.7,0.0,0.1,1.1,3.3,0.4,96.3,0.0,39902,37397,36611,2383,2383,1,36,440,1354,174,39955,0,3291,36611,1,35,404,914,7.9,88.2,0.0,0.1,1.0,2.2
E07000165,HARROGATE,78049,77651,91.8,56.5,54.5,21.0,21.1,0.8,1.8,2.8,7.7,0.9,97.1,6.5,71631,44131,42555,16423,16475,597,1407,2203,6020,732,75769,5106,29076,42555,597,810,796,3817,37.3,54.5,0.8,1.0,1.0,4.9
E09000015,HARROW,99137,98754,97.6,80.8,76.7,15.4,76.7,0.0,0.0,0.4,2.0,0.3,97.7,0.0,96798,80128,76080,15235,76079,14,47,434,1956,320,96902,0,20718,76080,14,33,387,1522,20.9,76.7,0.0,0.0,0.4,1.5
E07000089,HART,44063,43639,94.6,61.7,61.6,8.8,8.8,0.1,0.6,1.0,4.5,0.8,98.0,0.0,41676,27166,27133,3856,3856,35,254,437,1963,361,43201,0,14543,27133,35,219,183,1526,33.0,61.6,0.1,0.5,0.4,3.5
E06000001,HARTLEPOOL,47222,47007,96.1,88.2,88.1,3.6,3.6,0.3,0.6,1.2,3.4,0.5,96.7,0.0,45396,41627,41582,1682,1682,145,271,573,1611,222,45658,0,3814,41582,145,126,302,1038,8.1,88.1,0.3,0.3,0.6,2.2
E07000062,HASTINGS,46161,45920,98.2,3.2,3.2,3.2,3.2,0.0,0.0,0.1,1.3,0.2,99.4,0.0,45308,1464,1464,1464,1464,1,9,33,612,93,45864,0,43844,1464,1,8,24,579,95.0,3.2,0.0,0.0,0.1,1.3
E07000090,HAVANT,58059,57802,98.8,85.8,85.7,1.3,1.3,0.0,0.0,0.1,0.8,0.4,99.2,0.0,57358,49812,49780,769,770,1,26,75,444,209,57599,0,7578,49780,1,25,49,369,13.1,85.7,0.0,0.0,0.1,0.6
E09000016,HAVERING,113850,112369,95.7,82.6,80.3,4.7,78.7,0.0,0.2,0.5,3.0,1.4,96.6,0.0,108945,94028,91473,5323,89593,47,182,581,3424,1596,109934,0,17472,91473,47,135,399,2843,15.3,80.3,0.0,0.1,0.4,2.5
E06000019,"HEREFORDSHIRE, COUNTY OF",90471,89891,87.4,27.3,22.8,19.8,19.8,1.0,2.8,5.1,12.0,2.0,94.8,3.7,79070,24665,20621,17893,17893,931,2539,4583,10821,1781,85778,3335,58449,20621,931,1608,2044,6238,64.6,22.8,1.0,1.8,2.3,6.9
E07000098,HERTSMERE,46389,46298,97.5,76.4,73.7,6.6,6.6,0.0,0.2,0.4,2.3,0.2,98.7,0.0,45248,35453,34166,3081,3081,5,96,180,1050,76,45804,0,11082,34166,5,91,84,870,23.9,73.7,0.0,0.2,0.2,1.9
E07000037,HIGH PEAK,46139,45877,92.6,11.2,7.6,4.1,4.1,0.4,0.7,1.3,6.8,0.8,98.6,0.0,42734,5166,3495,1888,1888,177,342,621,3143,354,45506,0,39239,3495,177,165,279,2522,85.0,7.6,0.4,0.4,0.6,5.5
S12000017,HIGHLAND,115679,113050,81.2,11.5,11.5,11.5,11.5,2.3,4.6,7.7,16.5,3.9,93.1,4.4,93937,13296,13296,13296,13296,2670,5339,8963,19113,4555,107730,5080,80641,13296,2670,2669,3624,10150,69.7,11.5,2.3,2.3,3.1,8.8
E09000017,HILLINGDON,120470,119619,96.0,85.6,84.7,10.6,83.8,0.0,0.2,0.8,3.3,0.5,96.3,0.0,115684,103145,102013,12815,100930,50,293,1014,3935,592,115958,0,13671,102013,50,243,721,2921,11.3,84.7,0.0,0.2,0.6,2.4
E07000132,HINCKLEY AND BOSWORTH,54713,54163,96.1,64.6,62.0,10.1,10.1,0.1,0.9,1.1,2.9,0.9,98.0,0.0,52561,35370,33916,5503,5505,49,480,625,1602,471,53626,0,18645,33916,49,431,145,977,34.1,62.0,0.1,0.8,0.3,1.8
E07000227,HORSHAM,67182,66812,92.9,37.4,31.9,27.4,27.4,0.4,1.2,2.0,6.6,0.8,98.5,0.0,62392,25139,21454,18381,18381,264,793,1367,4420,561,66159,0,40938,21454,264,529,574,3053,60.9,31.9,0.4,0.8,0.9,4.5
E09000018,HOUNSLOW,101043,100534,97.3,86.0,85.9,12.0,85.9,0.0,0.1,0.3,2.1,0.4,97.4,0.0,98365,86929,86783,12108,86751,0,93,327,2169,446,98463,0,11582,86783,0,93,234,1842,11.5,85.9,0.0,0.1,0.2,1.8
E07000011,HUNTINGDONSHIRE,83473,82806,95.7,56.5,52.2,7.8,7.8,0.3,0.7,1.3,3.5,0.8,98.5,0.4,79877,47145,43537,6505,6505,279,618,1054,2929,695,82229,317,36340,43537,279,339,436,1875,43.5,52.2,0.3,0.4,0.5,2.2
E07000120,HYNDBURN,41224,40771,97.4,77.4,72.8,17.1,17.2,0.0,0.1,0.2,1.5,0.8,98.7,49.7,40139,31924,30009,7051,7084,18,33,92,632,328,40695,20476,10130,30009,18,15,59,540,24.6,72.8,0.0,0.0,0.1,1.3
S12000018,INVERCLYDE,42009,41959,96.8,73.2,72.9,9.9,9.9,0.1,0.4,0.7,3.1,0.2,98.4,0.0,40644,30767,30619,4157,4157,44,152,296,1315,97,41349,0,10025,30619,44,108,144,1019,23.9,72.9,0.1,0.3,0.3,2.4
E07000202,IPSWICH,65275,65109,98.1,87.2,84.1,13.4,13.4,0.0,0.1,0.4,1.7,0.2,98.4,0.0,64030,56939,54928,8720,8720,0,40,247,1079,138,64198,0,9102,54928,0,40,207,832,13.9,84.1,0.0,0.1,0.3,1.3
W06000001,ISLE OF ANGLESEY,37334,36851,88.3,16.2,16.2,16.2,16.2,0.9,2.2,3.9,10.4,2.1,94.6,25.3,32971,6031,6030,6030,6030,319,834,1442,3880,801,35316,9456,26941,6030,319,515,608,2438,72.2,16.2,0.9,1.4,1.6,6.5
E06000046,ISLE OF WIGHT,78386,77935,93.6,30.9,30.9,30.9,30.9,0.3,0.7,1.3,5.8,0.6,99.2,0.0,73369,24200,24200,24200,24200,233,578,1042,4566,460,77740,0,49169,24200,233,345,464,3524,62.7,30.9,0.3,0.4,0.6,4.5
E06000053,ISLES OF SCILLY,1681,1661,94.5,0.0,0.0,0.0,0.0,0.0,0.0,0.3,4.3,0.8,98.8,0.0,1589,0,0,0,0,0,0,5,72,13,1661,0,1589,0,0,0,5,67,94.5,0.0,0.0,0.0,0.3,4.0
E09000019,ISLINGTON,118698,118348,94.6,81.1,80.1,16.8,80.1,0.0,0.0,0.1,5.1,0.1,94.6,0.0,112283,96269,95123,19929,95125,0,0,70,6065,91,112295,0,17160,95123,0,0,70,5995,14.5,80.1,0.0,0.0,0.1,5.1
E09000020,KENSINGTON AND CHELSEA,98486,98275,95.7,87.2,83.3,19.9,80.5,0.0,0.0,0.1,4.1,0.1,95.7,0.0,94209,85890,81999,19560,79303,0,0,54,4066,63,94211,0,12210,81999,0,0,54,4012,12.4,83.3,0.0,0.0,0.1,4.1
E07000153,KETTERING,48809,48466,97.5,79.0,78.9,13.6,13.6,0.1,0.4,0.7,1.8,0.9,98.1,0.1,47606,38546,38509,6636,6636,33,192,324,860,416,47883,34,9097,38509,33,159,132,536,18.6,78.9,0.1,0.3,0.3,1.1
E07000146,"KING'S LYNN AND WEST NORFOLK",79044,78289,91.3,11.4,7.0,3.7,3.7,0.5,1.2,2.3,7.7,1.3,97.6,3.0,72200,8977,5544,2898,2898,357,938,1809,6089,999,77174,2399,66656,5544,357,581,871,4280,84.3,7.0,0.5,0.7,1.1,5.4
E06000010,"KINGSTON UPON HULL, CITY OF",128817,126861,98.5,97.5,97.5,97.5,97.5,0.0,0.0,0.0,0.0,0.2,98.5,21.1,126829,125638,125638,125638,125638,1,3,12,32,237,126829,27217,1191,125638,1,2,9,20,0.9,97.5,0.0,0.0,0.0,0.0
E09000021,KINGSTON UPON THAMES,70809,70584,97.8,90.3,86.7,3.8,84.7,0.0,0.0,0.1,1.9,0.2,98.0,0.0,69229,63917,61418,2696,59967,0,3,85,1355,175,69419,0,7811,61418,0,3,82,1270,11.0,86.7,0.0,0.0,0.1,1.8
E08000034,KIRKLEES,197064,196522,97.0,72.7,72.5,31.8,32.1,0.0,0.2,0.5,2.7,0.1,98.7,0.0,191141,143246,142863,62702,63265,79,381,984,5381,285,194537,0,48278,142863,79,302,603,4397,24.5,72.5,0.0,0.2,0.3,2.2
E08000011,KNOWSLEY,73134,72994,98.6,78.5,78.1,11.2,78.1,0.0,0.2,0.2,1.2,0.2,99.4,0.0,72114,57427,57106,8203,57095,15,123,182,880,124,72661,0,15008,57106,15,108,59,698,20.5,78.1,0.0,0.1,0.1,1.0
E09000022,LAMBETH,153952,153106,95.5,71.4,66.0,12.8,62.7,0.0,0.0,0.0,4.0,0.3,95.7,0.0,147017,109983,101599,19633,96564,0,0,30,6089,536,147292,0,45418,101599,0,0,30,6059,29.5,66.0,0.0,0.0,0.0,3.9
E07000121,LANCASTER,68007,67748,97.8,62.9,53.3,16.0,16.0,0.2,0.3,0.5,1.8,0.3,99.3,0.4,66525,42809,36279,10862,10862,141,206,326,1223,172,67556,303,30246,36279,141,65,120,897,44.5,53.3,0.2,0.1,0.2,1.3
E08000035,LEEDS,377079,375826,96.5,84.8,82.8,48.5,81.7,0.0,0.2,0.5,3.1,0.2,97.3,1.9,364062,319597,312224,182829,308101,115,918,1946,11764,917,366965,7246,51838,312224,115,803,1028,9818,13.7,82.8,0.0,0.2,0.3,2.6
E06000016,LEICESTER,145365,145115,98.8,92.2,91.2,13.0,13.0,0.0,0.0,0.2,1.0,0.1,99.1,0.0,143661,134017,132590,18894,18894,2,32,305,1454,191,143992,0,11071,132590,2,30,273,1149,7.6,91.2,0.0,0.0,0.2,0.8
E07000063,LEWES,47586,47428,96.3,24.9,24.7,24.9,24.9,0.1,0.3,0.6,3.4,0.3,99.4,0.0,45807,11868,11754,11837,11837,62,157,297,1621,131,47317,0,34053,11754,62,95,140,1324,71.6,24.7,0.1,0.2,0.3,2.8
E09000023,LEWISHAM,138064,137284,94.8,64.8,63.1,14.2,62.1,0.0,0.0,0.2,4.6,0.4,95.1,0.0,130916,89401,87060,19578,85725,0,0,295,6368,497,131260,0,43856,87060,0,0,295,6073,31.8,63.1,0.0,0.0,0.2,4.4
E07000194,LICHFIELD,49005,48798,95.7,69.2,64.7,8.5,61.4,0.3,0.6,1.2,3.9,0.3,99.2,0.0,46886,33909,31696,4158,30113,144,289,602,1912,167,48620,0,15190,31696,144,145,313,1310,31.0,64.7,0.3,0.3,0.6,2.7
E07000138,LINCOLN,48250,48155,98.0,81.2,80.2,1.1,1.1,0.0,0.1,0.5,1.8,0.1,98.3,23.9,47286,39155,38701,550,550,14,33,250,869,66,47414,11544,8585,38701,14,19,217,619,17.8,80.2,0.0,0.0,0.4,1.3
N09000007,LISBURN AND CASTLEREAGH,60778,60196,92.8,77.0,76.9,64.3,77.0,0.3,1.4,2.2,6.3,1.3,98.3,0.0,56384,46777,46723,39102,46776,187,822,1343,3812,776,59734,0,9661,46723,187,635,521,2469,15.9,76.9,0.3,1.0,0.9,4.1
E08000012,LIVERPOOL,237068,235884,94.5,81.0,78.4,35.2,76.7,0.0,0.0,0.4,5.0,0.4,94.9,0.0,224098,191958,185964,83331,181935,4,49,851,11786,836,224875,0,38134,185964,4,45,802,10935,16.1,78.4,0.0,0.0,0.3,4.6
E06000032,LUTON,86012,85711,99.1,92.6,90.1,4.6,4.6,0.0,0.2,0.2,0.6,0.1,99.2,0.0,85201,79679,77502,3955,3955,7,150,194,510,125,85298,0,7699,77502,7,143,44,316,9.0,90.1,0.0,0.2,0.1,0.4
E07000110,MAIDSTONE,78118,77707,91.8,62.6,56.9,15.2,15.2,0.6,1.6,2.6,7.6,1.0,97.3,0.0,71742,48895,44451,11883,11883,466,1260,2054,5965,765,76000,0,27291,44451,466,794,794,3911,34.9,56.9,0.6,1.0,1.0,5.0
E07000074,MALDON,30081,29968,94.1,24.0,24.0,24.0,24.0,0.4,1.1,2.2,5.6,0.8,98.8,0.0,28295,7216,7216,7216,7216,107,331,661,1673,245,29712,0,21079,7216,107,224,330,1012,70.1,24.0,0.4,0.7,1.1,3.4
E07000235,MALVERN HILLS,38200,38017,89.8,24.6,17.4,13.0,13.0,0.7,2.0,3.8,9.7,1.0,97.5,6.2,34322,9405,6649,4960,4960,255,783,1462,3695,389,37241,2353,27673,6649,255,528,679,2233,72.4,17.4,0.7,1.4,1.8,5.8
E08000003,MANCHESTER,246940,241922,92.8,73.3,70.1,26.5,61.7,0.1,0.2,0.9,5.2,0.9,93.2,0.0,229177,180931,172994,65456,152483,163,460,2343,12745,2261,230078,0,56183,172994,163,297,1883,10402,22.8,70.1,0.1,0.1,0.8,4.2
E07000174,MANSFIELD,52904,52798,98.8,88.4,85.7,9.1,9.1,0.0,0.1,0.2,1.0,0.1,99.4,0.0,52243,46785,45365,4816,4816,6,39,103,555,51,52588,0,6878,45365,6,33,64,452,13.0,85.7,0.0,0.1,0.1,0.9
E06000035,MEDWAY,121647,121311,97.1,81.7,77.9,5.0,5.0,0.0,0.3,0.7,2.7,0.2,98.6,0.0,118068,99371,94728,6122,6122,39,335,900,3243,246,119938,0,23340,94728,39,296,565,2343,19.2,77.9,0.0,0.2,0.5,1.9
E07000133,MELTON,24722,24595,93.3,46.5,46.1,2.1,2.1,0.8,2.0,3.1,6.2,1.2,96.9,2.4,23063,11497,11386,517,517,199,495,772,1532,299,23949,581,11677,11386,199,296,277,760,47.2,46.1,0.8,1.2,1.1,3.1
E07000187,MENDIP,55784,55585,86.3,46.4,41.1,19.6,19.6,0.5,2.2,5.2,13.4,1.2,94.2,0.2,48129,25857,22922,10937,10937,287,1219,2903,7456,685,52561,115,25207,22922,287,932,1684,4553,45.2,41.1,0.5,1.7,3.0,8.2
W06000024,MERTHYR TYDFIL,28459,28387,97.7,20.7,20.7,20.7,20.7,0.1,0.3,0.5,2.1,0.2,99.5,10.1,27802,5889,5889,5889,5889,42,77,130,585,52,28320,2883,21913,5889,42,35,53,455,77.0,20.7,0.1,0.1,0.2,1.6
E09000024,MERTON,89711,89570,98.2,88.5,86.8,30.9,86.8,0.0,0.0,0.2,1.6,0.1,98.3,0.0,88114,79425,77845,27718,77839,1,41,205,1456,99,88146,0,10269,77845,1,40,164,1251,11.4,86.8,0.0,0.0,0.2,1.4
N09000008,MID AND EAST ANTRIM,61571,60883,89.4,68.7,68.4,68.7,68.7,2.0,3.5,4.7,9.5,2.0,97.8,0.0,55063,42277,42133,42276,42277,1255,2136,2910,5820,1262,60200,0,12930,42133,1255,881,774,2910,21.0,68.4,2.0,1.4,1.3,4.7
E07000042,MID DEVON,37538,37231,78.1,7.7,7.7,7.6,7.6,1.9,5.9,10.5,21.1,3.0,91.6,11.6,29300,2873,2873,2871,2871,703,2207,3946,7931,1139,34377,4347,26427,2873,703,1504,1739,3985,70.4,7.7,1.9,4.0,4.6,10.6
E07000203,MID SUFFOLK,48166,47790,92.0,16.3,15.1,14.4,14.4,0.4,0.9,1.9,7.2,1.2,98.1,0.0,44327,7862,7257,6958,6958,212,457,922,3463,581,47231,0,37070,7257,212,245,465,2541,77.0,15.1,0.4,0.5,1.0,5.3
E07000228,MID SUSSEX,68409,68068,95.2,33.1,30.5,28.5,28.5,0.0,0.3,0.9,4.3,0.5,99.0,0.0,65111,22639,20866,19528,19528,33,177,587,2957,350,67719,0,44245,20866,33,144,410,2370,64.7,30.5,0.0,0.2,0.6,3.5
N09000009,MID ULSTER,55416,54599,78.0,40.1,40.1,40.1,40.1,3.6,6.8,10.1,20.5,5.1,97.5,4.5,43216,22197,22196,22196,22196,2015,3757,5588,11383,2821,54011,2491,21020,22196,2015,1742,1831,5795,37.9,40.1,3.6,3.1,3.3,10.5
E06000002,MIDDLESBROUGH,67892,67798,95.4,88.8,88.4,2.8,2.8,0.2,0.7,1.9,4.5,0.1,95.7,0.3,64749,60294,60038,1880,1880,113,504,1302,3049,97,65001,171,4711,60038,113,391,798,1747,6.9,88.4,0.2,0.6,1.2,2.6
S12000019,MIDLOTHIAN,42287,41850,93.3,41.3,40.9,41.3,41.3,0.7,1.6,2.7,5.7,1.2,97.4,5.2,39440,17454,17307,17452,17453,295,693,1152,2410,522,41169,2191,22133,17307,295,398,459,1258,52.3,40.9,0.7,0.9,1.1,3.0
E06000042,MILTON KEYNES,122065,121625,97.9,88.4,87.2,86.3,86.3,0.1,0.3,1.0,1.7,0.3,98.6,0.0,119515,107872,106427,105359,105362,99,407,1236,2110,382,120322,0,13088,106427,99,308,829,874,10.7,87.2,0.1,0.3,0.7,0.7
E07000210,MOLE VALLEY,39914,39822,95.3,59.2,59.1,10.3,10.3,0.1,0.3,0.8,4.5,0.5,99.2,0.0,38037,23618,23603,4111,4111,20,112,321,1785,188,39606,0,14434,23603,20,92,209,1464,36.2,59.1,0.1,0.2,0.5,3.7
W06000021,MONMOUTHSHIRE,45220,44849,86.2,25.6,16.4,10.3,10.3,1.4,3.5,6.3,13.0,2.7,95.2,0.2,38976,11560,7423,4658,4658,644,1574,2846,5873,1205,43049,79,31553,7423,644,930,1272,3027,69.8,16.4,1.4,2.1,2.8,6.7
S12000020,MORAY,49376,48946,84.3,13.2,13.2,13.2,13.2,1.7,4.6,7.1,14.8,3.4,95.3,0.0,41648,6519,6519,6519,6519,857,2248,3525,7298,1689,47042,0,35129,6519,857,1391,1277,3773,71.1,13.2,1.7,2.8,2.6,7.6
S12000013,NA H-EILEANAN SIAR,16675,15210,76.0,4.3,4.3,4.3,4.3,2.7,4.0,5.3,15.2,10.7,88.0,0.0,12674,709,709,709,709,443,673,885,2536,1781,14670,0,11965,709,443,230,212,1651,71.8,4.3,2.7,1.4,1.3,9.9
W06000012,NEATH PORT TALBOT,68942,68844,96.9,58.9,58.9,4.0,29.5,0.1,0.2,0.4,3.0,0.2,99.1,35.4,66801,40593,40581,2737,20361,62,160,299,2043,149,68321,24415,26220,40581,62,98,139,1744,38.0,58.9,0.1,0.1,0.2,2.5
E07000091,NEW FOREST,87435,87002,93.0,26.9,24.1,10.7,10.8,0.5,0.9,1.5,6.5,1.1,98.6,0.0,81346,23523,21106,9362,9404,435,746,1350,5656,922,86237,0,60240,21106,435,311,604,4306,68.9,24.1,0.5,0.4,0.7,4.9
E07000175,NEWARK AND SHERWOOD,59477,59066,95.1,54.4,54.1,14.3,14.3,0.3,0.9,1.5,4.2,0.7,98.1,0.0,56575,32358,32161,8490,8491,166,564,904,2491,445,58374,8,24414,32161,166,398,340,1587,41.0,54.1,0.3,0.7,0.6,2.7
E08000021,NEWCASTLE UPON TYNE,138327,137507,96.0,73.2,69.4,25.6,25.6,0.0,0.1,0.2,3.4,0.4,96.7,0.0,132837,101299,96040,35466,35466,62,150,331,4670,597,133766,0,36797,96040,62,88,181,4339,26.6,69.4,0.0,0.1,0.1,3.1
E07000195,NEWCASTLE-UNDER-LYME,60926,60360,95.8,66.6,65.4,11.8,11.8,0.0,0.4,0.8,3.3,0.9,98.3,2.1,58370,40584,39844,7171,7171,22,216,476,1990,539,59867,1263,18526,39844,22,194,260,1514,30.4,65.4,0.0,0.3,0.4,2.5
E09000025,NEWHAM,127741,127377,97.6,86.4,81.5,34.7,77.3,0.0,0.2,0.7,2.1,0.2,97.6,0.0,124709,110349,104052,44346,98695,12,192,885,2668,304,124735,0,20657,104052,12,180,693,1783,16.2,81.5,0.0,0.1,0.5,1.4
W06000022,NEWPORT,72308,72106,97.0,73.0,69.7,7.9,7.9,0.1,0.3,0.8,2.7,0.3,97.9,34.2,70150,52763,50382,5729,5729,73,235,607,1956,198,70773,24704,19768,50382,73,162,372,1349,27.3,69.7,0.1,0.2,0.5,1.9
N09000010,"NEWRY, MOURNE AND DOWN",70662,69168,83.0,54.0,53.8,54.0,54.0,2.8,5.3,7.4,14.9,4.1,97.1,3.3,58618,38168,38031,38168,38168,2003,3715,5249,10550,2919,68645,2307,20587,38031,2003,1712,1534,5301,29.1,53.8,2.8,2.4,2.2,7.5
S12000021,NORTH AYRSHIRE,72102,71921,94.3,31.2,31.2,13.1,13.1,0.4,0.9,1.8,5.4,0.5,98.8,0.0,68026,22481,22473,9476,9476,318,634,1281,3895,373,71252,0,45553,22473,318,316,647,2614,63.2,31.2,0.4,0.4,0.9,3.6
E07000043,NORTH DEVON,51531,51099,86.1,5.8,5.8,5.8,5.8,1.5,3.5,6.6,13.0,1.9,93.5,53.1,44385,2971,2971,2971,2971,779,1821,3403,6714,954,48198,27375,41414,2971,779,1042,1582,3311,80.4,5.8,1.5,2.0,3.1,6.4
E07000038,NORTH EAST DERBYSHIRE,48639,48499,93.8,35.1,32.9,31.6,31.6,0.3,0.8,1.2,5.9,0.3,99.0,0.0,45608,17068,16009,15353,15353,156,383,601,2891,166,48173,0,29599,16009,156,227,218,2290,60.9,32.9,0.3,0.5,0.4,4.7
E06000012,NORTH EAST LINCOLNSHIRE,74187,74050,96.8,88.9,88.5,1.4,1.4,0.1,0.9,1.3,3.0,0.4,97.6,25.8,71820,65984,65645,1055,1055,74,642,962,2230,290,72437,19125,6175,65645,74,568,320,1268,8.3,88.5,0.1,0.8,0.4,1.7
E07000099,NORTH HERTFORDSHIRE,60979,60795,95.9,70.9,69.4,3.5,3.5,0.1,0.4,1.0,3.8,0.4,98.1,0.0,58485,43216,42299,2115,2115,58,231,627,2310,267,59823,0,16186,42299,58,173,396,1683,26.5,69.4,0.1,0.3,0.6,2.8
E07000139,NORTH KESTEVEN,54816,54536,93.5,36.2,34.6,4.3,4.3,0.7,1.4,2.1,6.0,0.9,97.7,4.8,51239,19832,18948,2346,2346,380,756,1173,3297,502,53582,2657,32291,18948,380,376,417,2124,58.9,34.6,0.7,0.7,0.8,3.9
S12000050,NORTH LANARKSHIRE,165038,164826,97.8,76.6,75.4,11.4,75.2,0.1,0.3,0.6,2.1,0.2,99.0,0.0,161373,126429,124442,18887,124185,88,523,1049,3453,356,163322,0,36931,124442,88,435,526,2404,22.4,75.4,0.1,0.3,0.3,1.5
E06000013,NORTH LINCOLNSHIRE,80580,80168,93.6,46.2,46.2,6.9,6.9,0.6,1.2,1.8,5.9,0.6,97.2,51.7,75435,37236,37213,5599,5599,464,970,1486,4733,497,78330,41683,38222,37213,464,506,516,3247,47.4,46.2,0.6,0.6,0.6,4.0
E07000147,NORTH NORFOLK,60586,60237,90.4,4.4,4.4,4.4,4.4,0.6,1.7,2.9,9.1,2.1,97.2,0.1,54749,2655,2655,2648,2648,334,1030,1766,5488,1264,58862,61,52094,2655,334,696,736,3722,86.0,4.4,0.6,1.1,1.2,6.1
E06000024,NORTH SOMERSET,103348,102379,92.0,55.3,48.8,26.5,26.5,0.2,0.7,1.4,7.1,0.9,95.8,0.0,95080,57191,50427,27361,27361,243,702,1491,7299,904,98961,0,44653,50427,243,459,789,5808,43.2,48.8,0.2,0.4,0.8,5.6
E08000022,NORTH TYNESIDE,102409,102191,98.5,72.9,70.0,15.8,15.8,0.0,0.2,0.4,1.3,0.2,99.2,0.0,100844,74613,71658,16216,16216,32,165,394,1347,243,101569,0,29186,71658,32,133,229,953,28.5,70.0,0.0,0.1,0.2,0.9
E07000218,NORTH WARWICKSHIRE,30350,30239,96.0,32.8,30.9,16.5,29.6,0.3,0.9,1.4,3.6,0.4,99.1,0.0,29135,9967,9393,5009,8975,77,271,418,1104,112,30074,0,19742,9393,77,194,147,686,65.0,30.9,0.3,0.6,0.5,2.3
E07000134,NORTH WEST LEICESTERSHIRE,48651,48514,96.4,69.1,67.5,6.2,6.2,0.2,0.7,1.1,3.3,0.4,99.0,0.0,46913,33609,32824,2993,2993,83,348,552,1601,198,48168,0,14089,32824,83,265,204,1049,29.0,67.5,0.2,0.5,0.4,2.2
E07000154,NORTHAMPTON,105585,103883,97.6,87.6,86.0,20.6,20.6,0.0,0.0,0.1,0.8,1.6,97.8,1.2,103066,92530,90853,21716,21717,4,29,138,817,1642,103292,1262,12213,90853,4,25,109,679,11.6,86.0,0.0,0.0,0.1,0.6
E06000057,NORTHUMBERLAND,157733,157201,92.8,14.7,9.2,5.9,5.9,0.9,1.7,2.5,6.8,0.9,98.5,5.4,146448,23153,14503,9326,9326,1371,2710,3959,10753,1410,155425,8565,131945,14503,1371,1339,1249,6794,83.7,9.2,0.9,0.8,0.8,4.3
E07000148,NORWICH,58296,58096,98.4,85.1,82.3,4.1,4.1,0.0,0.0,0.4,1.3,0.2,98.6,0.0,57364,49632,47959,2404,2404,0,8,262,732,111,57505,0,9405,47959,0,8,254,470,16.1,82.3,0.0,0.0,0.4,0.8
E06000018,NOTTINGHAM,144261,143886,98.2,92.6,91.0,23.4,23.4,0.0,0.1,0.2,1.5,0.1,98.4,0.0,141676,133608,131239,33804,33804,11,77,350,2210,126,141903,0,10437,131239,11,66,273,1860,7.2,91.0,0.0,0.0,0.2,1.3
E07000219,NUNEATON AND BEDWORTH,60563,60416,98.7,79.4,79.4,7.7,79.4,0.0,0.2,0.3,1.1,0.2,99.4,0.0,59761,48108,48087,4667,48090,15,117,154,655,115,60178,0,11674,48087,15,102,37,501,19.3,79.4,0.0,0.2,0.1,0.8
E07000135,OADBY AND WIGSTON,25814,25480,97.4,78.0,75.3,3.1,3.1,0.0,0.0,0.1,1.3,1.2,98.0,0.0,25142,20132,19449,805,805,0,2,23,338,322,25298,0,5693,19449,0,2,21,315,22.1,75.3,0.0,0.0,0.1,1.2
E08000004,OLDHAM,98693,98419,98.1,76.4,76.1,16.9,17.1,0.1,0.2,0.3,1.6,0.2,99.5,0.0,96842,75395,75078,16633,16829,72,168,316,1577,229,98170,0,21764,75078,72,96,148,1261,22.1,76.1,0.1,0.1,0.1,1.3
S12000023,ORKNEY ISLANDS,12798,12222,64.7,1.1,1.1,1.1,1.1,4.0,9.3,20.3,30.8,7.3,76.6,0.0,8274,143,143,143,143,516,1190,2593,3948,939,9806,0,8131,143,516,674,1403,1355,63.5,1.1,4.0,5.3,11.0,10.6
E07000178,OXFORD,65737,65260,97.4,84.8,77.8,2.3,2.3,0.0,0.0,0.4,1.8,0.3,97.5,0.0,64048,55745,51144,1521,1521,0,31,264,1212,198,64122,0,12904,51144,0,31,233,948,19.6,77.8,0.0,0.0,0.4,1.4
W06000009,PEMBROKESHIRE,65833,65589,87.6,6.4,6.4,6.4,6.4,1.8,4.0,6.7,12.1,2.2,94.8,5.1,57638,4190,4190,4185,4190,1200,2662,4409,7951,1447,62386,3361,53448,4190,1200,1462,1747,3542,81.2,6.4,1.8,2.2,2.7,5.4
E07000122,PENDLE,43967,43669,95.8,52.7,52.4,1.6,51.9,0.4,0.9,1.3,3.6,0.7,98.4,4.2,42099,23167,23022,683,22827,175,401,555,1570,287,43270,1825,19077,23022,175,226,154,1015,43.4,52.4,0.4,0.5,0.4,2.3
S12000048,PERTH AND KINROSS,78806,78161,85.2,36.0,35.1,5.6,5.6,1.7,4.2,7.2,14.0,2.4,95.0,0.0,67146,28350,27637,4421,4421,1333,3318,5701,11015,1891,74881,0,39509,27637,1333,1985,2383,5314,50.1,35.1,1.7,2.5,3.0,6.7
E06000031,PETERBOROUGH,92153,91974,98.0,82.5,81.9,59.4,59.4,0.1,0.3,0.5,1.8,0.2,99.0,0.0,90333,76063,75437,54738,54738,72,308,473,1641,196,91241,0,14896,75437,72,236,165,1168,16.2,81.9,0.1,0.3,0.2,1.3
E06000026,PLYMOUTH,123362,123091,97.3,87.8,86.6,2.4,2.4,0.0,0.2,0.9,2.5,0.2,97.7,27.1,119986,108260,106831,2950,2951,4,234,1087,3105,189,120575,33378,13155,106831,4,230,853,2018,10.7,86.6,0.0,0.2,0.7,1.6
E06000044,PORTSMOUTH,95619,95397,97.2,92.6,90.1,12.2,12.2,0.0,0.1,0.5,2.6,0.2,97.3,0.0,92905,88575,86181,11697,11697,1,122,469,2492,181,93041,0,6724,86181,1,121,347,2023,7.0,90.1,0.0,0.1,0.4,2.1
W06000023,POWYS,69416,68257,77.4,16.2,16.2,16.2,16.2,3.4,7.2,12.0,20.9,5.8,87.7,7.1,53720,11241,11240,11238,11238,2347,5000,8363,14537,4000,60894,4921,42480,11240,2347,2653,3363,6174,61.2,16.2,3.4,3.8,4.8,8.9
E07000123,PRESTON,67702,67337,97.1,71.1,68.8,6.0,6.0,0.0,0.1,0.5,2.3,0.5,98.4,34.7,65748,48131,46595,4068,4068,27,54,315,1589,311,66614,23501,19153,46595,27,27,261,1274,28.3,68.8,0.0,0.0,0.4,1.9
E06000038,READING,75207,75012,98.6,89.2,85.5,10.1,82.9,0.0,0.0,0.1,1.2,0.2,98.8,0.0,74124,67096,64317,7598,62364,3,31,79,888,184,74269,0,9807,64317,3,28,48,809,13.0,85.5,0.0,0.0,0.1,1.1
E09000026,REDBRIDGE,111203,110715,97.1,85.2,81.7,30.0,81.1,0.0,0.1,0.3,2.4,0.4,97.4,0.0,108019,94742,90834,33347,90233,13,104,385,2696,401,108306,0,17185,90834,13,91,281,2311,15.5,81.7,0.0,0.1,0.3,2.1
E06000003,REDCAR AND CLEVELAND,68108,68029,96.3,85.0,83.7,1.2,1.2,0.2,0.9,1.7,3.6,0.3,97.6,0.3,65602,57881,57013,835,835,113,601,1148,2427,189,66474,237,8589,57013,113,488,547,1279,12.6,83.7,0.2,0.7,0.8,1.9
E07000236,REDDITCH,39494,39387,97.9,78.2,77.4,2.0,77.4,0.0,0.0,0.1,1.8,0.2,98.8,0.1,38671,30865,30568,796,30572,2,15,47,716,86,39036,31,8103,30568,2,13,32,669,20.5,77.4,0.0,0.0,0.1,1.7
E07000211,REIGATE AND BANSTEAD,64224,64126,97.4,74.2,73.4,22.9,22.9,0.0,0.1,0.2,2.4,0.2,99.7,0.0,62573,47630,47109,14698,14707,17,89,154,1553,118,64008,0,15464,47109,17,72,65,1399,24.1,73.4,0.0,0.1,0.1,2.2
S12000038,RENFREWSHIRE,94961,94557,95.6,75.0,74.9,13.6,46.0,0.1,0.4,0.8,4.0,0.1,97.4,0.0,90805,71250,71160,12930,43700,118,359,787,3752,100,92507,0,19645,71160,118,241,428,2965,20.7,74.9,0.1,0.3,0.5,3.1
W06000016,RHONDDA CYNON TAF,118934,118240,97.2,22.3,18.1,8.6,15.9,0.1,0.1,0.5,2.3,0.6,98.7,26.9,115547,26529,21538,10261,18938,64,126,552,2693,665,117375,32044,94009,21538,64,62,426,2141,79.0,18.1,0.1,0.1,0.4,1.8
E07000124,RIBBLE VALLEY,30287,30105,90.3,23.4,23.1,22.1,22.4,0.7,2.2,3.7,9.1,0.8,98.2,51.4,27362,7076,6988,6679,6777,224,658,1125,2743,242,29734,15577,20374,6988,224,434,467,1618,67.3,23.1,0.7,1.4,1.5,5.3
E09000027,RICHMOND UPON THAMES,88802,88590,97.7,85.9,84.2,16.2,83.1,0.0,0.0,0.3,2.1,0.2,97.9,0.0,86760,76279,74800,14367,73816,0,19,257,1830,160,86893,0,11960,74800,0,19,238,1573,13.5,84.2,0.0,0.0,0.3,1.8
E07000166,RICHMONDSHIRE,25258,25022,84.2,24.5,12.8,5.3,5.3,2.4,4.9,8.0,14.8,3.2,95.8,34.3,21272,6179,3243,1332,1332,609,1235,2021,3750,796,24200,8671,18029,3243,609,626,786,1729,71.4,12.8,2.4,2.5,3.1,6.8
E08000005,ROCHDALE,101121,100796,97.6,71.0,64.9,10.7,10.7,0.0,0.1,0.4,2.1,0.2,99.1,0.0,98709,71758,65677,10802,10807,30,132,407,2087,220,100201,0,33032,65677,30,102,275,1680,32.7,64.9,0.0,0.1,0.3,1.7
E07000075,ROCHFORD,37944,37699,97.0,17.1,12.0,8.0,8.0,0.0,0.2,0.4,2.3,0.5,98.9,0.0,36816,6495,4538,3030,3030,2,73,167,883,197,37534,0,32278,4538,2,71,94,716,85.1,12.0,0.0,0.2,0.2,1.9
E07000125,ROSSENDALE,34962,34674,94.0,52.9,43.3,1.3,1.3,0.1,0.8,1.0,5.2,0.8,98.1,0.0,32857,18501,15143,444,444,32,265,350,1817,268,34308,12,17714,15143,32,233,85,1467,50.7,43.3,0.1,0.7,0.2,4.2
E07000064,ROTHER,49388,49054,93.6,6.1,6.1,6.1,6.1,0.1,0.3,1.1,5.7,0.6,99.0,0.0,46220,3014,3014,3014,3014,55,158,543,2834,291,48880,0,43206,3014,55,103,385,2291,87.5,6.1,0.1,0.2,0.8,4.6
E08000018,ROTHERHAM,124658,124394,98.1,62.4,60.0,12.7,12.7,0.0,0.2,0.5,1.7,0.2,99.2,0.4,122307,77819,74833,15805,15806,34,245,609,2087,250,123641,526,47474,74833,34,211,364,1478,38.1,60.0,0.0,0.2,0.3,1.2
E07000220,RUGBY,50413,50250,96.9,68.1,64.6,16.5,61.8,0.3,0.6,0.9,2.8,0.4,98.7,0.0,48852,34313,32584,8297,31142,134,303,478,1398,177,49770,0,16268,32584,134,169,175,920,32.3,64.6,0.3,0.3,0.3,1.8
E07000212,RUNNYMEDE,38599,38418,96.2,71.1,68.7,3.6,3.7,0.0,0.1,0.8,3.3,0.2,97.7,0.0,37141,27431,26509,1408,1409,4,49,295,1277,93,37719,0,10632,26509,4,45,246,982,27.5,68.7,0.0,0.1,0.6,2.5
E07000176,RUSHCLIFFE,54214,54048,97.1,75.3,72.1,26.6,26.6,0.2,0.4,0.8,2.6,0.3,99.3,0.5,52633,40838,39063,14396,14396,99,219,458,1415,179,53817,268,13570,39063,99,120,239,957,25.0,72.1,0.2,0.2,0.4,1.8
E07000092,RUSHMOOR,42959,42808,97.0,81.4,81.1,4.3,4.3,0.1,0.9,1.7,2.7,0.2,97.2,0.0,41653,34964,34850,1830,1830,64,402,736,1155,87,41760,0,6803,34850,64,338,334,419,15.8,81.1,0.1,0.8,0.8,1.0
E06000017,RUTLAND,18648,18568,91.7,12.8,12.8,12.8,12.8,0.3,0.5,0.9,7.9,0.5,98.9,0.0,17103,2382,2382,2382,2382,53,90,170,1465,89,18443,0,14721,2382,53,37,80,1295,78.9,12.8,0.3,0.2,0.4,6.9
E07000167,RYEDALE,30293,29602,83.3,7.6,7.6,7.6,7.6,3.0,5.6,8.1,14.4,4.0,94.0,17.6,25237,2314,2314,2314,2314,921,1686,2457,4365,1222,28467,5323,22923,2314,921,765,771,1908,75.7,7.6,3.0,2.5,2.5,6.3
E08000006,SALFORD,128988,128636,95.5,82.5,82.1,56.4,81.8,0.0,0.8,2.0,4.2,0.2,95.7,0.0,123198,106434,105849,72756,105451,13,987,2579,5438,196,123430,0,17349,105849,13,974,1592,2859,13.5,82.1,0.0,0.8,1.2,2.2
E08000028,SANDWELL,142189,141852,99.1,82.8,81.2,15.0,71.4,0.0,0.0,0.3,0.7,0.1,99.1,0.0,140891,117782,115430,21296,101574,16,40,357,961,204,140977,1,25461,115430,16,24,317,604,17.9,81.2,0.0,0.0,0.2,0.4
E07000168,SCARBOROUGH,63496,63256,93.4,2.7,2.7,2.7,2.7,0.6,1.3,1.9,6.2,0.7,97.7,1.8,59316,1723,1723,1720,1720,391,814,1214,3940,429,62020,1117,57593,1723,391,423,400,2726,90.7,2.7,0.6,0.7,0.6,4.3
S12000026,SCOTTISH BORDERS,62644,61636,85.6,20.7,17.7,15.6,15.6,1.8,4.2,7.2,12.7,3.5,94.6,14.7,53654,12970,11079,9765,9765,1128,2645,4488,7982,2169,59239,9195,42575,11079,1128,1517,1843,3494,68.0,17.7,1.8,2.4,2.9,5.6
E07000188,SEDGEMOOR,59508,59280,92.9,32.3,19.8,12.5,12.5,0.3,1.0,2.0,6.7,0.8,97.2,0.0,55295,19237,11765,7440,7440,162,583,1219,3985,499,57855,0,43530,11765,162,421,636,2766,73.1,19.8,0.3,0.7,1.1,4.6
E08000014,SEFTON,135439,134818,98.1,71.5,65.8,30.8,61.2,0.0,0.1,0.2,1.5,0.2,99.2,0.0,132853,96786,89162,41757,82895,16,108,277,1965,274,134305,0,43691,89162,16,92,169,1688,32.3,65.8,0.0,0.1,0.1,1.2
E07000169,SELBY,43121,42833,92.4,19.6,19.6,19.6,19.6,0.8,1.5,2.4,6.9,1.0,97.6,13.9,39863,8443,8442,8440,8441,339,635,1035,2970,419,42104,6013,31421,8442,339,296,400,1935,72.9,19.6,0.8,0.7,0.9,4.5
E07000111,SEVENOAKS,53404,53213,92.3,44.7,44.4,20.2,38.9,0.2,0.6,1.2,7.3,0.5,99.2,0.0,49302,23884,23710,10804,20782,102,299,637,3911,250,52975,0,25592,23710,102,197,338,3274,47.9,44.4,0.2,0.4,0.6,6.1
E08000019,SHEFFIELD,261570,260782,96.0,51.4,47.8,8.7,8.7,0.0,0.2,0.8,3.7,0.3,97.0,0.1,251125,134536,124978,22629,22630,56,415,2221,9657,677,253851,198,126147,124978,56,359,1806,7436,48.2,47.8,0.0,0.1,0.7,2.8
S12000027,SHETLAND ISLANDS,11590,11189,70.1,1.8,1.8,1.8,1.8,3.0,7.1,16.8,26.5,6.5,83.5,0.0,8120,214,214,214,214,350,827,1942,3069,759,9682,0,7906,214,350,477,1115,1127,68.2,1.8,3.0,4.1,9.6,9.7
E06000051,SHROPSHIRE,153239,152311,86.1,22.2,16.3,9.4,9.4,1.0,3.0,5.8,13.3,1.0,95.4,78.0,131979,33950,25008,14331,14331,1485,4593,8856,20332,1559,146266,119522,106971,25008,1485,3108,4263,11476,69.8,16.3,1.0,2.0,2.8,7.5
E06000039,SLOUGH,57725,57549,98.7,90.5,87.0,25.9,27.8,0.0,0.1,0.2,1.0,0.2,98.9,0.0,56973,52252,50194,14940,16027,11,57,128,576,135,57095,0,6779,50194,11,46,71,448,11.7,87.0,0.0,0.1,0.1,0.8
E08000029,SOLIHULL,97203,96825,97.2,87.7,86.8,29.3,86.2,0.0,0.3,1.0,2.4,0.2,98.0,0.0,94523,85289,84407,28507,83777,37,282,973,2302,168,95214,1,10116,84407,37,245,691,1329,10.4,86.8,0.0,0.3,0.7,1.4
E07000246,SOMERSET WEST AND TAUNTON,77772,77318,88.0,24.2,14.2,6.8,6.8,0.9,2.7,5.0,11.4,1.6,95.3,5.5,68459,18802,11065,5258,5258,671,2077,3893,8859,1266,74148,4287,57394,11065,671,1406,1816,4966,73.8,14.2,0.9,1.8,2.3,6.4
S12000028,SOUTH AYRSHIRE,58831,58742,93.9,58.3,57.1,5.3,5.3,0.4,1.3,2.7,5.9,1.0,98.3,0.0,55253,34301,33612,3113,3113,215,748,1565,3489,561,57854,0,21641,33612,215,533,817,1924,36.8,57.1,0.4,0.9,1.4,3.3
E07000012,SOUTH CAMBRIDGESHIRE,71363,71033,95.1,54.9,52.5,16.3,16.3,0.2,0.5,1.4,4.4,0.5,98.2,0.8,67874,39199,37447,11611,11614,148,390,1020,3159,325,70089,547,30427,37447,148,242,630,2139,42.6,52.5,0.2,0.3,0.9,3.0
E07000039,SOUTH DERBYSHIRE,48921,48425,93.6,36.5,31.4,23.4,23.4,0.3,1.0,1.5,5.4,0.9,98.1,0.0,45780,17857,15364,11452,11452,125,470,721,2645,422,48006,0,30416,15364,125,345,251,1924,62.2,31.4,0.3,0.7,0.5,3.9
E06000025,SOUTH GLOUCESTERSHIRE,126519,126083,97.9,79.5,78.4,13.0,13.0,0.1,0.2,0.7,1.8,0.3,99.0,0.0,123826,100606,99245,16413,16413,123,281,900,2257,346,125257,0,24581,99245,123,158,619,1357,19.4,78.4,0.1,0.1,0.5,1.1
E07000044,SOUTH HAMS,48565,48211,81.7,24.3,23.5,19.9,19.9,0.8,2.9,7.4,17.6,2.4,94.0,32.0,39666,11795,11403,9659,9659,410,1418,3589,8545,1163,45671,15537,28263,11403,410,1008,2171,4956,58.2,23.5,0.8,2.1,4.5,10.2
E07000140,SOUTH HOLLAND,44116,43804,88.5,12.3,8.9,6.6,6.6,0.5,1.7,3.2,10.8,1.4,98.4,0.5,39061,5437,3911,2916,2916,211,753,1414,4743,625,43392,231,35150,3911,211,542,661,3329,79.7,8.9,0.5,1.2,1.5,7.5
E07000141,SOUTH KESTEVEN,68612,68409,93.2,33.8,32.2,6.1,6.1,0.9,1.4,2.0,6.5,0.4,98.3,0.0,63927,23199,22059,4161,4161,641,993,1394,4482,302,67472,0,41868,22059,641,352,401,3088,61.0,32.2,0.9,0.5,0.6,4.5
E07000031,SOUTH LAKELAND,60371,60117,93.2,13.7,12.2,11.2,11.2,0.4,1.1,1.9,6.3,1.0,98.2,38.6,56284,8274,7338,6736,6736,258,637,1121,3833,618,59274,23287,48946,7338,258,379,484,2712,81.1,12.2,0.4,0.6,0.8,4.5
S12000029,SOUTH LANARKSHIRE,160715,160393,95.7,67.1,66.6,12.9,66.3,0.4,1.0,2.0,4.1,0.5,98.5,0.0,153751,107842,106965,20721,106592,693,1650,3187,6642,793,158273,0,46786,106965,693,957,1537,3455,29.1,66.6,0.4,0.6,1.0,2.1
E07000149,SOUTH NORFOLK,65926,65717,91.2,15.9,14.9,10.2,10.2,0.4,1.3,2.5,8.5,1.4,98.3,0.0,60098,10462,9804,6712,6712,249,881,1677,5619,921,64783,0,50294,9804,249,632,796,3942,76.3,14.9,0.4,1.0,1.2,6.0
E07000155,SOUTH NORTHAMPTONSHIRE,43073,42885,93.0,36.5,29.1,24.2,24.2,0.3,2.0,2.9,6.5,0.9,96.2,0.7,40078,15713,12517,10409,10409,110,879,1253,2807,379,41449,284,27561,12517,110,769,374,1554,64.0,29.1,0.3,1.8,0.9,3.6
E07000179,SOUTH OXFORDSHIRE,66846,66488,95.9,51.3,46.2,23.7,23.7,0.1,0.4,0.7,3.6,0.7,99.2,0.0,64078,34318,30859,15829,15830,80,282,501,2410,435,66310,0,33219,30859,80,202,219,1909,49.7,46.2,0.1,0.3,0.3,2.9
E07000126,SOUTH RIBBLE,53111,52986,96.8,68.5,67.0,6.3,6.3,0.1,0.4,0.8,3.0,0.2,98.9,6.9,51412,36356,35565,3327,3327,27,217,440,1574,121,52530,3685,15847,35565,27,190,223,1134,29.8,67.0,0.1,0.4,0.4,2.1
E07000189,SOUTH SOMERSET,84382,83562,88.2,6.2,5.9,5.8,5.8,0.6,2.4,4.2,10.8,1.5,96.4,4.2,74445,5224,4957,4856,4856,508,1991,3549,9117,1304,81362,3564,69488,4957,508,1483,1558,5568,82.3,5.9,0.6,1.8,1.8,6.6
E07000196,SOUTH STAFFORDSHIRE,49970,49780,92.1,35.9,31.5,28.5,28.6,0.2,1.0,2.1,7.6,0.3,98.3,5.4,46004,17963,15730,14241,14313,115,486,1066,3776,135,49102,2711,30274,15730,115,371,580,2710,60.6,31.5,0.2,0.7,1.2,5.4
E08000023,SOUTH TYNESIDE,75627,75586,97.8,76.8,76.3,1.3,1.3,0.1,0.3,0.6,2.1,0.0,98.8,0.0,73973,58095,57667,995,995,50,232,422,1613,34,74717,0,16306,57667,50,182,190,1191,21.6,76.3,0.1,0.2,0.3,1.6
E06000045,SOUTHAMPTON,113725,113394,96.8,90.4,87.3,10.3,77.3,0.0,0.0,0.6,2.9,0.3,97.1,0.0,110104,102751,99278,11759,87918,4,30,723,3290,292,110434,0,10826,99278,4,26,693,2567,9.5,87.3,0.0,0.0,0.6,2.3
E06000033,SOUTHEND-ON-SEA,86844,86470,97.0,73.5,67.4,26.6,26.6,0.0,0.0,0.0,2.6,0.1,97.3,0.0,84226,63817,58509,23141,23141,0,3,16,2244,127,84528,0,25717,58509,0,3,13,2228,29.6,67.4,0.0,0.0,0.0,2.6
E09000028,SOUTHWARK,149290,148517,92.9,76.7,75.6,44.4,75.1,0.0,0.0,0.3,6.6,0.4,92.9,0.0,138738,114493,112790,66308,112166,0,62,401,9779,548,138763,0,25948,112790,0,62,339,9378,17.4,75.6,0.0,0.0,0.2,6.3
E07000213,SPELTHORNE,45004,44770,96.3,80.4,78.9,22.8,22.8,0.0,0.0,0.9,3.2,0.3,97.0,0.0,43343,36177,35504,10278,10278,0,14,384,1427,151,43668,0,7839,35504,0,14,370,1043,17.4,78.9,0.0,0.0,0.8,2.3
E07000240,ST ALBANS,64707,64535,97.0,84.0,81.6,29.4,29.4,0.0,0.1,0.3,2.8,0.2,98.4,0.0,62745,54351,52808,19047,19047,30,70,195,1790,120,63652,0,9937,52808,30,40,125,1595,15.4,81.6,0.0,0.1,0.2,2.5
E08000013,ST. HELENS,88297,88058,97.2,84.3,83.6,6.2,81.3,0.1,0.5,0.9,2.5,0.2,98.6,1.2,85807,74436,73801,5478,71759,100,399,753,2251,180,87062,1051,12006,73801,100,299,354,1498,13.6,83.6,0.1,0.3,0.4,1.7
E07000197,STAFFORD,65262,65093,93.9,64.3,64.1,12.7,15.5,0.3,0.9,2.0,5.8,0.4,98.3,0.7,61300,41942,41831,8270,10093,182,617,1276,3793,273,64176,453,19469,41831,182,435,659,2517,29.8,64.1,0.3,0.7,1.0,3.9
E07000198,STAFFORDSHIRE MOORLANDS,46686,46513,91.0,28.2,27.2,3.0,3.0,0.6,1.7,3.4,8.7,1.3,97.6,0.0,42462,13160,12686,1381,1381,296,790,1576,4051,613,45557,0,29776,12686,296,494,786,2475,63.8,27.2,0.6,1.1,1.7,5.3
E07000243,STEVENAGE,39600,39461,99.0,86.4,86.1,1.5,1.5,0.0,0.0,0.1,0.7,0.2,99.1,0.0,39190,34211,34094,579,579,0,18,37,271,96,39230,0,5096,34094,0,18,19,234,12.9,86.1,0.0,0.0,0.0,0.6
S12000030,STIRLING,46432,45731,88.6,52.2,50.0,48.8,48.9,1.4,3.0,4.8,9.9,3.4,95.7,0.0,41142,24250,23194,22673,22683,653,1409,2234,4589,1582,44421,0,17948,23194,653,756,825,2355,38.7,50.0,1.4,1.6,1.8,5.1
E08000007,STOCKPORT,139948,139164,98.1,82.8,82.6,5.0,29.1,0.0,0.2,0.2,1.4,0.4,98.7,0.0,137239,115852,115642,7038,40736,24,213,300,1925,500,138150,0,21597,115642,24,189,87,1625,15.4,82.6,0.0,0.1,0.1,1.2
E06000004,STOCKTON-ON-TEES,92587,92372,95.1,85.6,84.8,4.8,4.8,0.1,0.9,2.2,4.7,0.2,95.9,3.5,88033,79222,78531,4468,4468,115,815,2000,4339,209,88799,3202,9502,78531,115,700,1185,2339,10.3,84.8,0.1,0.8,1.3,2.5
E06000021,STOKE-ON-TRENT,123268,122866,97.7,80.3,80.2,4.9,4.9,0.0,0.1,0.4,2.0,0.2,98.4,0.0,120447,98973,98881,6060,6060,0,79,499,2419,222,121332,0,21566,98881,0,79,420,1920,17.5,80.2,0.0,0.1,0.3,1.6
E07000221,STRATFORD-ON-AVON,65613,65251,93.4,42.4,37.0,15.6,33.0,0.4,1.2,2.0,6.0,0.7,97.6,0.1,61311,27834,24268,10214,21622,272,770,1328,3940,444,64045,47,37043,24268,272,498,558,2612,56.5,37.0,0.4,0.8,0.9,4.0
E07000082,STROUD,57167,56953,90.1,18.4,18.3,14.7,14.7,0.4,1.2,2.5,9.6,0.5,94.5,0.3,51489,10494,10458,8419,8419,216,673,1451,5464,265,54034,184,41031,10458,216,457,778,4013,71.8,18.3,0.4,0.8,1.4,7.0
E08000024,SUNDERLAND,137060,136417,96.3,64.8,60.3,8.7,8.7,0.1,0.2,0.9,3.2,0.5,97.5,0.0,131970,88761,82631,11858,11858,115,342,1302,4447,672,133586,0,49339,82631,115,227,960,3145,36.0,60.3,0.1,0.2,0.7,2.3
E07000214,SURREY HEATH,38754,38651,97.9,66.7,65.9,8.3,8.3,0.0,0.0,0.1,1.8,0.2,99.6,0.0,37935,25866,25552,3206,3206,1,17,51,716,65,38596,0,12383,25552,1,16,34,665,32.0,65.9,0.0,0.0,0.1,1.7
E09000029,SUTTON,87408,87202,98.2,86.3,84.4,6.7,83.5,0.0,0.0,0.2,1.6,0.2,98.4,0.0,85797,75416,73736,5886,73001,11,19,148,1405,148,86000,0,12061,73736,11,8,129,1257,13.8,84.4,0.0,0.0,0.1,1.4
E07000113,SWALE,67603,67070,93.0,45.5,39.0,10.2,10.2,0.2,0.8,1.7,6.2,0.7,98.1,0.0,62861,30732,26362,6881,6881,147,512,1167,4209,480,66300,0,36499,26362,147,365,655,3042,54.0,39.0,0.2,0.5,1.0,4.5
W06000011,SWANSEA,118678,118222,97.4,80.0,77.2,29.9,29.9,0.1,0.3,0.6,2.3,0.4,98.3,51.7,115545,94918,91599,35457,35465,132,300,725,2677,520,116637,61364,23946,91599,132,168,425,1952,20.2,77.2,0.1,0.1,0.4,1.6
E06000030,SWINDON,102269,102212,92.9,83.6,81.0,18.3,18.3,0.0,0.8,1.9,7.1,0.7,93.3,0.0,94958,85453,82788,18673,18673,41,811,1962,7254,762,95468,0,12170,82788,41,770,1151,5292,11.9,81.0,0.0,0.8,1.1,5.2
E08000008,TAMESIDE,116080,115389,96.7,57.0,56.1,17.6,17.6,0.0,0.0,0.2,2.7,0.4,99.0,0.0,112295,66110,65079,20429,20440,4,37,209,3094,443,114863,0,47216,65079,4,33,172,2885,40.7,56.1,0.0,0.0,0.1,2.5
E07000199,TAMWORTH,35409,35339,99.0,85.3,82.1,3.9,79.7,0.1,0.1,0.2,0.8,0.2,99.5,0.0,35067,30208,29056,1373,28221,35,44,81,272,55,35229,0,6011,29056,35,9,37,191,17.0,82.1,0.1,0.0,0.1,0.5
E07000215,TANDRIDGE,38659,38502,93.5,50.3,48.3,12.3,12.3,0.1,0.7,1.2,6.1,0.4,99.0,0.0,36132,19451,18660,4736,4754,48,254,454,2370,173,38284,0,17472,18660,48,206,200,1916,45.2,48.3,0.1,0.5,0.5,5.0
E07000045,TEIGNBRIDGE,66403,66094,88.5,36.6,36.4,11.0,11.0,0.5,1.7,3.7,11.0,1.1,96.4,29.0,58772,24317,24180,7287,7287,301,1157,2456,7322,708,63996,19247,34592,24180,301,856,1299,4866,52.1,36.4,0.5,1.3,2.0,7.3
E06000020,TELFORD AND WREKIN,82052,81789,97.4,79.8,76.9,7.0,7.0,0.1,0.2,0.4,2.2,0.2,98.8,38.5,79948,65500,63133,5782,5782,63,152,364,1841,170,81082,31597,16815,63133,63,89,212,1477,20.5,76.9,0.1,0.1,0.3,1.8
E07000076,TENDRING,74474,74101,96.2,8.9,8.9,8.9,8.9,0.4,0.9,1.4,3.2,0.5,98.3,0.0,71681,6616,6616,6608,6608,282,641,1036,2420,392,73245,0,65065,6616,282,359,395,1384,87.4,8.9,0.4,0.5,0.5,1.9
E07000093,TEST VALLEY,59247,59095,93.5,65.5,64.5,16.0,18.1,0.2,0.9,2.1,6.2,0.7,98.5,0.0,55417,38791,38240,9450,10740,139,523,1242,3678,417,58370,0,17177,38240,139,384,719,2436,29.0,64.5,0.2,0.6,1.2,4.1
E07000083,TEWKESBURY,46712,45996,90.3,57.4,55.2,26.5,26.5,0.2,1.1,2.2,8.1,2.0,92.3,0.0,42191,26832,25792,12380,12380,110,534,1018,3805,943,43098,9,16399,25792,110,424,484,2787,35.1,55.2,0.2,0.9,1.0,6.0
E07000114,THANET,73160,72651,96.5,53.0,52.7,52.8,52.8,0.0,0.3,1.4,2.8,0.6,98.8,0.0,70625,38762,38534,38665,38665,13,222,1021,2026,409,72315,0,32091,38534,13,209,799,1005,43.9,52.7,0.0,0.3,1.1,1.4
E07000102,THREE RIVERS,39492,39362,96.5,77.6,74.9,10.9,11.0,0.2,0.3,0.6,3.2,0.1,99.4,0.0,38103,30655,29571,4310,4327,91,132,220,1259,52,39236,0,8532,29571,91,41,88,1039,21.6,74.9,0.2,0.1,0.2,2.6
E06000034,THURROCK,72140,71993,95.2,75.7,74.2,13.3,13.3,0.1,0.5,2.0,4.6,0.2,96.8,0.0,68695,54582,53553,9578,9578,80,376,1444,3298,157,69841,0,15142,53553,80,296,1068,1854,21.0,74.2,0.1,0.4,1.5,2.6
E07000115,TONBRIDGE AND MALLING,57241,57077,94.4,62.4,59.5,12.8,12.8,0.2,0.5,1.3,5.3,0.4,98.2,0.0,54050,35719,34081,7301,7301,93,262,726,3027,251,56210,0,19969,34081,93,169,464,2301,34.9,59.5,0.2,0.3,0.8,4.0
E06000027,TORBAY,78194,77565,93.8,72.6,68.1,34.1,34.1,0.0,0.0,0.5,5.4,0.5,95.9,0.2,73368,56739,53286,26671,26671,17,27,417,4197,430,75020,129,20082,53286,17,10,390,3780,25.7,68.1,0.0,0.0,0.5,4.8
W06000020,TORFAEN,45842,45668,96.1,49.9,40.7,11.7,11.7,0.2,0.5,1.3,3.6,0.4,97.3,65.3,44038,22878,18669,5381,5381,72,224,593,1630,171,44603,29931,25369,18669,72,152,369,1037,55.3,40.7,0.2,0.3,0.8,2.3
E07000046,TORRIDGE,34449,34126,80.6,3.5,3.5,3.5,3.5,2.6,7.0,11.2,18.5,2.2,92.2,46.3,27752,1221,1220,1220,1220,888,2401,3853,6374,743,31767,15965,26532,1220,888,1513,1452,2521,77.0,3.5,2.6,4.4,4.2,7.3
E09000030,TOWER HAMLETS,145531,144781,92.1,70.5,67.3,44.1,65.2,0.0,0.0,0.6,7.4,0.3,92.1,0.0,134056,102622,98014,64221,94866,1,55,857,10725,491,134095,0,36042,98014,1,54,802,9868,24.8,67.3,0.0,0.0,0.6,6.8
E08000009,TRAFFORD,107843,107429,97.7,71.0,66.4,2.6,63.0,0.1,0.2,0.4,1.9,0.3,98.8,0.0,105360,76534,71588,2769,67954,60,256,384,2069,376,106554,0,33772,71588,60,196,128,1685,31.3,66.4,0.1,0.2,0.1,1.6
E07000116,TUNBRIDGE WELLS,52777,52535,91.8,47.6,42.2,9.2,9.2,0.1,1.2,2.6,7.8,1.2,98.0,0.0,48434,25142,22287,4856,4856,67,611,1348,4101,614,51729,0,26147,22287,67,544,737,2753,49.5,42.2,0.1,1.0,1.4,5.2
E07000077,UTTLESFORD,41207,40839,88.7,42.0,39.8,23.4,23.4,0.5,1.5,4.1,10.4,1.6,93.9,0.0,36550,17324,16405,9641,9641,209,613,1696,4289,658,38692,0,20145,16405,209,404,1083,2593,48.9,39.8,0.5,1.0,2.6,6.3
W06000014,VALE OF GLAMORGAN,62831,62496,96.3,62.7,58.7,32.4,56.0,0.2,1.0,1.5,3.1,0.7,97.9,10.7,60524,39417,36864,20343,35155,156,630,917,1972,458,61504,6737,23660,36864,156,474,287,1055,37.7,58.7,0.2,0.8,0.5,1.7
E07000180,VALE OF WHITE HORSE,62188,61946,96.1,62.7,60.3,16.9,16.9,0.1,0.3,0.7,3.5,0.3,98.7,0.0,59764,39008,37514,10502,10503,73,193,465,2182,176,61388,0,22250,37514,73,120,272,1717,35.8,60.3,0.1,0.2,0.4,2.8
E08000036,WAKEFIELD,159966,159177,95.9,55.9,55.3,22.2,22.2,0.0,0.4,0.7,3.6,0.5,97.9,0.4,153439,89478,88485,35580,35581,79,578,1100,5738,822,156597,590,64954,88485,79,499,522,4638,40.6,55.3,0.0,0.3,0.3,2.9
E08000030,WALSALL,118359,117956,98.1,77.9,75.6,11.3,73.5,0.0,0.0,0.5,1.5,0.2,98.7,0.0,116153,92167,89533,13357,87044,3,22,572,1803,236,116801,0,26620,89533,3,19,550,1231,22.5,75.6,0.0,0.0,0.5,1.0
E09000031,WALTHAM FOREST,110227,109701,96.0,87.8,86.9,17.7,86.3,0.0,0.1,0.6,3.6,0.4,96.1,0.0,105782,96800,95785,19548,95147,33,74,705,3919,460,105874,0,9997,95785,33,41,631,3214,9.1,86.9,0.0,0.0,0.6,2.9
E09000032,WANDSWORTH,157102,155987,96.7,83.3,75.3,30.3,67.6,0.0,0.0,0.2,2.6,0.5,96.7,0.0,151885,130915,118230,47660,106232,1,13,345,4102,792,151926,0,33655,118230,1,12,332,3757,21.4,75.3,0.0,0.0,0.2,2.4
E06000007,WARRINGTON,99546,99011,96.8,71.8,68.5,3.7,66.5,0.0,0.1,0.2,2.7,0.4,98.8,0.0,96311,71460,68162,3721,66167,43,128,229,2700,380,98344,0,28149,68162,43,85,101,2471,28.3,68.5,0.0,0.1,0.1,2.5
E07000222,WARWICK,69529,69354,97.7,79.1,74.2,11.9,70.7,0.1,0.5,0.7,2.0,0.2,99.2,0.0,67953,54996,51594,8273,49158,92,334,495,1401,160,68946,1,16359,51594,92,242,161,906,23.5,74.2,0.1,0.3,0.2,1.3
E07000103,WATFORD,42459,42167,98.7,90.2,85.9,3.0,3.0,0.0,0.0,0.2,0.6,0.6,98.8,0.0,41925,38304,36472,1288,1290,0,18,67,242,247,41956,0,5453,36472,0,18,49,175,12.8,85.9,0.0,0.0,0.1,0.4
E07000216,WAVERLEY,56742,56573,93.6,19.6,16.2,5.6,5.6,0.2,0.6,1.0,6.1,0.5,99.3,0.0,53134,11136,9198,3199,3199,125,330,561,3439,312,56351,0,43936,9198,125,205,231,2878,77.4,16.2,0.2,0.4,0.4,5.1
E07000065,WEALDEN,74072,73818,94.1,17.5,17.3,17.2,17.2,0.2,0.7,1.4,5.6,0.7,99.1,0.0,69672,12934,12808,12771,12771,161,522,1030,4146,534,73391,0,56864,12808,161,361,508,3116,76.8,17.3,0.2,0.5,0.7,4.2
E07000156,WELLINGBOROUGH,37937,37868,97.4,64.5,64.4,6.0,6.0,0.1,0.6,1.0,2.4,0.2,98.8,14.1,36952,24463,24418,2288,2288,55,209,383,916,72,37499,5335,12534,24418,55,154,174,533,33.0,64.4,0.1,0.4,0.5,1.4
E07000241,WELWYN HATFIELD,50534,50442,96.9,75.6,73.3,9.3,9.3,0.0,0.1,0.4,2.9,0.1,98.9,0.0,48967,38192,37030,4716,4716,12,46,178,1475,63,49996,0,11937,37030,12,34,132,1297,23.6,73.3,0.0,0.1,0.3,2.6
E06000037,WEST BERKSHIRE,71990,71789,97.2,73.2,68.4,26.9,65.1,0.0,0.4,0.7,2.5,0.3,98.2,0.0,69965,52682,49273,19353,46898,27,313,492,1824,195,70709,0,20692,49273,27,286,179,1332,28.7,68.4,0.0,0.4,0.2,1.9
E07000047,WEST DEVON,27056,26924,78.3,28.4,28.4,28.4,28.4,1.8,6.0,11.8,21.3,2.0,95.0,68.0,21172,7680,7680,7680,7680,477,1622,3182,5752,552,25696,18401,13492,7680,477,1145,1560,2570,49.9,28.4,1.8,4.2,5.8,9.5
S12000039,WEST DUNBARTONSHIRE,47084,47051,98.3,89.7,88.4,1.1,87.2,0.1,0.2,0.5,1.6,0.1,99.1,0.0,46295,42211,41616,535,41070,32,102,236,756,42,46638,0,4679,41616,32,70,134,520,9.9,88.4,0.1,0.1,0.3,1.1
E07000127,WEST LANCASHIRE,51905,51737,94.5,47.1,37.5,31.2,31.3,0.2,0.8,1.4,5.1,0.3,98.6,5.5,49069,24437,19443,16206,16227,122,418,714,2668,145,51202,2852,29626,19443,122,296,296,1954,57.1,37.5,0.2,0.6,0.6,3.8
E07000142,WEST LINDSEY,46314,45975,85.5,33.7,31.5,19.6,19.6,2.1,4.6,7.1,13.7,1.6,96.5,26.1,39619,15617,14567,9058,9058,991,2142,3284,6356,754,44702,12076,25052,14567,991,1151,1142,3072,54.1,31.5,2.1,2.5,2.5,6.6
S12000040,WEST LOTHIAN,86373,86199,96.9,77.7,76.2,38.7,75.5,0.2,0.4,1.0,2.9,0.3,98.8,0.0,83706,67078,65809,33403,65226,138,359,849,2493,271,85366,0,17897,65809,138,221,490,1644,20.7,76.2,0.2,0.3,0.6,1.9
E07000181,WEST OXFORDSHIRE,52685,52468,98.3,67.8,61.0,30.0,30.0,0.0,0.1,0.3,1.3,0.4,99.1,0.0,51793,35716,32128,15790,15790,22,57,169,675,227,52212,0,19665,32128,22,35,112,506,37.3,61.0,0.0,0.1,0.2,1.0
E07000245,WEST SUFFOLK,84567,84349,95.1,31.1,24.4,13.1,13.1,0.2,0.4,0.7,4.6,0.4,99.0,0.1,80446,26330,20675,11081,11081,137,359,626,3903,367,83729,119,59771,20675,137,222,267,3277,70.7,24.4,0.2,0.3,0.3,3.9
E09000033,WESTMINSTER,164465,162942,88.6,62.5,60.9,56.2,59.0,0.0,0.0,0.1,10.5,0.3,88.6,0.0,145696,102747,100134,92397,97110,0,0,86,17246,542,145730,0,45562,100134,0,0,86,17160,27.7,60.9,0.0,0.0,0.1,10.4
E08000010,WIGAN,153817,153731,98.6,86.6,85.5,4.9,12.3,0.0,0.1,0.2,1.4,0.1,99.5,0.1,151588,133157,131445,7485,18925,34,145,372,2143,93,153091,103,20143,131445,34,111,227,1771,13.1,85.5,0.0,0.1,0.1,1.2
E06000054,WILTSHIRE,233768,233043,94.4,45.4,43.9,21.9,21.9,0.2,0.8,1.5,5.2,0.6,98.6,1.0,220776,106225,102682,51244,51244,537,1757,3498,12267,1318,230476,2323,118094,102682,537,1220,1741,8769,50.5,43.9,0.2,0.5,0.7,3.8
E07000094,WINCHESTER,56541,56375,91.4,46.2,44.3,8.7,8.8,0.4,1.3,2.5,8.3,0.8,97.4,0.0,51671,26140,25058,4944,4965,253,723,1412,4704,430,55088,0,26613,25058,253,470,689,3292,47.1,44.3,0.4,0.8,1.2,5.8
E06000040,WINDSOR AND MAIDENHEAD,67606,67427,94.2,61.9,57.4,5.0,5.0,0.2,0.4,1.0,5.5,0.3,97.7,0.0,63707,41853,38824,3396,3397,124,287,696,3720,200,66061,0,24883,38824,124,163,409,3024,36.8,57.4,0.2,0.2,0.6,4.5
E08000015,WIRRAL,158330,158075,97.9,72.7,72.5,46.6,46.6,0.0,0.1,0.2,1.9,0.1,99.5,0.0,155081,115116,114814,73757,73759,45,116,244,2994,136,157510,0,40267,114814,45,71,128,2750,25.4,72.5,0.0,0.0,0.1,1.7
E07000217,WOKING,45400,45189,98.0,84.7,81.1,3.7,3.7,0.0,0.3,0.3,1.6,0.2,99.1,0.0,44482,38462,36801,1663,1663,1,141,157,707,108,44975,0,7681,36801,1,140,16,550,16.9,81.1,0.0,0.3,0.0,1.2
E06000041,WOKINGHAM,76006,74935,94.1,70.4,67.2,13.1,65.3,0.1,0.3,0.8,4.5,1.4,96.4,0.0,71543,53509,51078,9969,49657,69,194,587,3392,1073,73234,0,20465,51078,69,125,393,2805,26.9,67.2,0.1,0.2,0.5,3.7
E08000031,WOLVERHAMPTON,117775,117423,98.1,89.4,83.1,5.8,6.0,0.0,0.1,0.2,1.6,0.2,98.5,5.0,115512,105245,97915,6810,7038,1,94,290,1911,275,115994,5938,17597,97915,1,93,196,1621,14.9,83.1,0.0,0.1,0.2,1.4
E07000237,WORCESTER,48778,48568,98.6,21.5,10.3,2.5,2.5,0.0,0.0,0.1,1.0,0.2,99.2,0.1,48075,10506,5001,1232,1232,0,1,28,493,106,48378,49,43074,5001,0,1,27,465,88.3,10.3,0.0,0.0,0.1,1.0
E07000229,WORTHING,51710,51655,99.3,92.9,92.4,52.1,52.1,0.0,0.0,0.0,0.6,0.1,99.7,0.0,51342,48017,47763,26953,26953,2,4,9,313,40,51562,0,3579,47763,2,2,5,304,6.9,92.4,0.0,0.0,0.0,0.6
W06000006,WREXHAM,65902,65108,94.1,39.8,39.1,38.8,38.8,0.3,1.0,2.0,4.7,1.5,96.7,43.9,62040,26250,25793,25575,25575,202,676,1290,3068,978,63726,28921,36247,25793,202,474,614,1778,55.0,39.1,0.3,0.7,0.9,2.7
E07000238,WYCHAVON,62691,62239,93.8,20.3,16.3,9.1,9.2,0.2,0.8,1.4,5.5,0.8,98.3,0.4,58774,12727,10233,5678,5784,108,507,877,3465,487,61650,224,48541,10233,108,399,370,2588,77.4,16.3,0.2,0.6,0.6,4.1
E07000128,WYRE,56708,56482,94.7,29.0,29.0,28.6,28.6,0.1,0.3,0.8,4.9,0.3,98.2,0.3,53724,16472,16467,16215,16215,50,195,433,2758,154,55681,187,37257,16467,50,145,238,2325,65.7,29.0,0.1,0.3,0.4,4.1
E07000239,WYRE FOREST,48306,48091,96.6,48.1,47.7,2.1,47.7,0.2,0.5,0.8,2.9,0.4,99.2,3.5,46678,23236,23046,1035,23045,106,231,395,1413,194,47934,1675,23632,23046,106,125,164,1018,48.9,47.7,0.2,0.3,0.3,2.1
E06000014,YORK,96063,95484,94.1,76.6,73.4,58.2,58.2,0.0,0.2,0.7,5.3,0.3,95.8,3.7,90353,73628,70543,55942,55942,40,187,687,5131,299,91992,3521,19810,70543,40,147,500,4444,20.6,73.4,0.0,0.2,0.5,4.6
